ⲙⲁⲗⲓⲥⲧⲁ	avve_grec
ⲙⲁⲗⲓⲥⲧⲁ	avve_grec
[....]ⲥ
[...]ϥ̣
ϣⲁ	tripprep_nomi_egizsost_verb_asso
ⲧⲣⲉ	caus_nomicaus_pron
ⲉⲣϣⲁⲛ	trip
ⲉϥϣⲁⲛ	trip
ⲉⲓϣⲁⲛ	trip
ⲉⲕϣⲁⲛ	trip
ⲉⲛϣⲁⲛ	trip
ⲉⲣϣⲁⲛ	trip
ⲉⲥϣⲁⲛ
ⲉⲩϣⲁⲛ	trip
ⲛ	refe_partrefe_dimo_artinegatripconvprep_nomi_egizattrsost_verb_nomisost_verb_pron
ⲛⲧⲁ	trip
ⲧⲁ	part_triprefe_partrefe_dimo_possrefe_dimo_pron
ϣⲁϩⲣⲁⲓ	avve_egiz
ϣⲁϩⲣⲁⲓⲉⲡⲟⲟⲩⲛϩⲟⲟⲩ	avve_egiz
ϣⲁⲃⲟⲗ	avve_egiz
ϣⲁⲉϩⲣⲁⲓ	avve_egiz
ϣⲁⲉⲛⲉϩ	avve_egiz
ϣⲁⲛⲧⲉⲟⲩϣⲱⲡⲉ	avve_egiz
ϣⲁⲡⲉⲓⲙⲁ	avve_egiz
ϣⲁⲧⲛⲁⲩ	avve_egiz
ϩⲁϩⲛⲥⲟⲡ	avve_egiz
ϩⲁⲑⲏ	avve_egiz
ϩⲁⲡⲉⲥⲏⲧ	avve_egiz
ϩⲁⲡⲗⲱⲥ	avve_grec
ϩⲉⲛⲟⲩϣⲉⲡϩⲙⲟⲧ	avve_egiz
ϩⲉⲛⲟⲩϣⲡϩⲙⲟⲧ	avve_egiz
ϩⲉⲛⲟⲩϩⲙⲟⲧ	avve_egiz
ϩⲉⲛⲟⲩϩⲱⲡ	avve_egiz
ϩⲉⲛⲟⲩϫⲱⲕ	avve_egiz
ϩⲉⲛⲟⲩϭⲉⲡⲏ	avve_egiz
ϩⲉⲛⲟⲩⲡⲉⲑⲏⲡ	avve_egiz
ϩⲉⲛⲥⲟⲡ	avve_egiz
ϩⲓⲃⲟⲗ	avve_egiz
ϩⲓⲑⲏ	avve_egiz
ϩⲓⲛⲁⲓ	avve_egiz
ϩⲓⲟⲩⲥⲟⲡ	avve_egiz
ϩⲓⲡⲉⲥⲏⲧ	avve_egiz
ϩⲙⲙⲁⲛⲓⲙ	avve_egiz
ϩⲙⲡⲉϩⲟⲟⲩⲙⲛⲧⲉⲩϣⲏ	avve_egiz
ϩⲙⲡⲉⲓⲙⲁ	avve_egiz
ϩⲙⲡⲉⲓⲟⲩⲟⲉⲓϣ	avve_egiz
ϩⲙⲡⲉⲟⲩⲟⲉⲓϣⲉⲧⲙⲙⲁⲩ	avve_egiz
ϩⲙⲡⲓⲟⲩⲟⲉⲓϣ	avve_egiz
ϩⲙⲡⲙⲁⲉⲧⲙⲙⲁⲩ	avve_egiz
ϩⲙⲡⲥⲁⲥⲛⲁⲩ	avve_egiz
ϩⲛⲕⲉⲙⲁ	avve_egiz
ϩⲛⲟⲩϣⲉⲡϩⲙⲟⲧ	avve_egiz
ϩⲛⲟⲩϣⲡϩⲙⲟⲧ	avve_egiz
ϩⲛⲟⲩϣⲡⲉⲛϣⲱⲡ	avve_egiz
ϩⲛⲟⲩϣⲡⲛϣⲱⲡ	avve_egiz
ϩⲛⲟⲩϩⲙⲟⲧ	avve_egiz
ϩⲛⲟⲩϩⲱⲡ	avve_egiz
ϩⲛⲟⲩϫⲱⲕ	avve_egiz
ϩⲛⲟⲩϭⲉⲡⲏ	avve_egiz
ϩⲛⲟⲩⲙⲉ	avve_egiz
ϩⲛⲟⲩⲟⲩⲱⲛϩⲉⲃⲟⲗ	avve_egiz
ϩⲛⲟⲩⲡⲉⲑⲏⲡ	avve_egiz
ϩⲛⲧⲉⲩϣⲏ	avve_egiz
ϩⲛⲧⲉⲩⲛⲟⲩ	avve_egiz
ϩⲛⲧⲉⲩⲛⲟⲩⲉⲧⲙⲙⲁⲩ	avve_egiz
ϩⲟⲗⲟⲥ	avve_grec
ϩⲟⲗⲱⲥ	avve_grec
ϩⲟⲙⲟⲓⲱⲥ	avve_grec
ϩⲟⲙⲱⲥ	avve_grec
ϩⲟⲩⲉ	avve_egiz
ϩⲣⲁⲉⲓ	avve_egiz
ϩⲣⲁⲓ	avve_egizavve_egiz
ϩⲱⲗⲟⲥ	avve_grec
ϩⲱⲗⲱⲥ	avve_grec
ϩⲱⲙⲟⲓⲱⲥ	avve_grec
ϫⲓ	avve_egizprep_nomi_egizsost_verb_assosost_verb_nomisost_verb_pron
ϫⲓⲛ	avve_egizprep_nomi_egiz
ϫⲓⲛϣⲟⲣⲡ	avve_egiz
ϫⲓⲛⲉⲡⲉⲩⲟⲉⲓϣ	avve_egiz
ϫⲓⲛⲉⲡⲉⲩⲟⲉⲓϣⲉⲧⲙⲙⲁⲩ	avve_egiz
ϫⲓⲛⲛϣⲟⲣⲡ	avve_egiz
ϫⲓⲛⲧⲉⲛⲟⲩ	avve_egiz
ⲁϫⲛⲱϫⲛ	avve_egiz
ⲁⲗⲏⲑⲱⲥ	avve_grec
ⲁⲡⲟⲙⲉⲣⲟⲩⲥ	avve_grec
ⲁⲡⲟⲥⲧⲏⲑⲟⲩⲥ	avve_grec
ⲃⲉⲣⲉⲧⲱⲥ	avve_grec
ⲇⲓⲕⲁⲓⲱⲥ	avve_grec
ⲉϩⲟⲩⲉ
ⲉϩⲟⲩⲛ	avve_egiz
ⲉϩⲣⲁⲓ	avve_egiz
ⲉⲃⲟⲗ	avve_egiz
ⲉⲑⲏ	avve_egiz
ⲉⲙⲁϣⲟ	avve_egiz
ⲉⲙⲁⲧⲉ	avve_egiz
ⲉⲙⲁⲩ	avve_egiz
ⲉⲛⲉϩ	sost_asso_egiz_masc_sipl
ⲉⲡϩⲁⲉ	avve_egiz
ⲉⲡϫⲓⲛϫⲏ	avve_egiz
ⲉⲡⲁϩⲟⲩ	avve_egiz
ⲉⲡⲉϩⲟⲩⲟ	avve_egiz
ⲉⲡⲉⲓⲥⲁⲙⲛⲡⲁⲓ	avve_egiz
ⲉⲡⲉⲥⲏⲧ	avve_egiz
ⲉⲡⲧⲏⲣϥ	avve_egiz
ⲉⲧⲉⲧⲁⲓⲧⲉ	avve_egizcong_egiz
ⲉⲧⲓ	avve_grec
ⲉⲩⲗⲟⲅⲱⲥ	avve_grec
ⲕⲁϩⲏⲩ	avve_egiz
ⲕⲁⲕⲱⲥ	avve_grec
ⲕⲁⲗⲟⲥ	avve_grec
ⲕⲁⲗⲱⲥ	avve_grec
ⲕⲁⲧⲁⲑⲉⲉⲧⲥⲏϩ	avve_egiz
ⲕⲁⲧⲁⲑⲉⲧⲥⲏϩ	avve_egiz
ⲕⲁⲧⲁⲕⲁⲓⲣⲟⲥ	avve_grec
ⲕⲁⲧⲁⲙⲁ	avve_egiz
ⲕⲁⲧⲁⲡϣⲓ	avve_egiz
ⲕⲁⲧⲁⲡⲉⲉⲧⲥⲏϩ	avve_egiz
ⲕⲁⲧⲁⲡⲉⲧⲥⲏϩ	avve_egiz
ⲙⲁⲗⲗⲟⲛ	avve_grec
ⲙⲉϣⲁⲕ	avve_egiz
ⲙⲙⲁⲧⲉ	avve_egiz
ⲙⲙⲁⲩ	avve_egiz
ⲙⲙⲏⲛⲉ	avve_egiz
ⲙⲙⲓⲛⲉⲙⲓⲛⲉ	avve_egiz
ⲙⲟⲅⲓⲥ	avve_grec
ⲙⲡⲁⲧⲉⲱⲥⲕϣⲱⲡⲉ	avve_egiz
ⲙⲡⲉϥⲣⲁⲥⲧⲉ	avve_egiz
ⲙⲡⲉϩⲟⲟⲩⲙⲛⲧⲉⲩϣⲏ	avve_egiz
ⲙⲡⲉⲓⲙⲁ	avve_egiz
ⲙⲡⲉⲓⲟⲩⲟⲉⲓϣ	avve_egiz
ⲙⲡⲉⲓⲥⲟⲡ	avve_egiz
ⲙⲡⲉⲟⲩⲟⲉⲓϣⲉⲧⲙⲙⲁⲩ	avve_egiz
ⲙⲡⲉⲥⲏⲧ	avve_egiz
ⲙⲡⲉⲥⲛⲁⲩ	avve_egiz
ⲙⲡⲉⲩⲟⲉⲓϣⲉⲧⲙⲙⲁⲩ	avve_egiz
ⲙⲡⲓⲟⲩⲟⲉⲓϣ	avve_egiz
ⲙⲡⲛⲁⲩⲉⲧⲙⲙⲁⲩ	avve_egiz
ⲙⲡⲛⲁⲩⲙⲡⲟⲩⲟⲉⲓⲛ	avve_egiz
ⲙⲡⲟⲟⲩ	avve_egiz
ⲙⲡⲟⲩⲉ	avve_egiz
ⲙⲡⲥⲁⲥⲛⲁⲩ	avve_egiz
ⲙⲡⲥⲟⲡ	avve_egiz
ⲙⲱⲅⲓⲥ	avve_grec
ⲛϩⲁϩⲛⲥⲟⲡ	avve_egiz
ⲛϩⲟϩⲓϩⲟ	avve_egiz
ⲛϩⲟⲥⲟⲛ	avve_grec
ⲛϩⲟⲩⲛ	avve_egiz
ⲛϩⲟⲩⲟ	avve_egiz
ⲛϩⲱⲥⲟⲛ	avve_grec
ⲛϫⲓⲟⲩⲉ	avve_egiz
ⲛϯⲙⲓⲛⲉ	avve_egiz
ⲛⲁϣⲛϩⲉ	avve_egiz
ⲛⲁⲙⲉ	avve_egiz
ⲛⲁⲟⲩⲟⲩⲛⲟⲩ	avve_egiz
ⲛⲁⲡϣⲁⲩ	avve_egiz
ⲛⲑⲉⲉⲧⲥⲏϩ	avve_egiz
ⲛⲑⲉⲧⲥⲏϩ	avve_egiz
ⲛⲕⲉⲥⲟⲡ	avve_egiz
ⲛⲛⲁⲩⲛⲓⲙ	avve_egiz
ⲛⲟⲩϣⲏⲙ	avve_egiz
ⲛⲟⲩⲏⲣ	avve_egiz
ⲛⲟⲩⲟⲉⲓϣⲛⲓⲙ	avve_egiz
ⲛⲟⲩⲥⲟⲡ	avve_egiz
ⲛⲥⲁϥ	avve_egiz
ⲛⲥⲁⲟⲩⲥⲁ	avve_egiz
ⲛⲥⲁⲡⲉⲓⲥⲁⲙⲛⲡⲁⲓ	avve_egiz
ⲛⲥⲁⲥⲁⲛⲓⲙ	avve_egiz
ⲛⲧⲉⲓϩⲉ	avve_egiz
ⲛⲧⲉⲓϭⲟⲧ	avve_egiz
ⲛⲧⲉⲓⲙⲓⲛⲉ	avve_egiz
ⲛⲧⲉⲛϩⲉ	avve_egiz
ⲛⲧⲉⲟⲩⲛⲟⲩ	avve_egiz
ⲛⲧⲉⲩϣⲏ	avve_egiz
ⲛⲧⲉⲩϩⲉ	avve_egiz
ⲛⲧⲉⲩⲛⲟⲩ	avve_egiz
ⲛⲧⲓⲙⲓⲛⲉ	avve_egiz
ⲟⲛ	cong_egiz
ⲟⲛⲧⲟⲥ	avve_grec
ⲟⲛⲧⲱⲥ	avve_grec
ⲡⲁⲗⲓⲛ	cong_grec
ⲡⲁⲛⲧⲟⲥ	avve_grec
ⲡⲁⲛⲧⲱⲥ	avve_grec
ⲡⲉⲩϣⲟⲙⲛⲧ	avve_egiz
ⲡⲛⲉⲩⲙⲁⲧⲓⲕⲱⲥ	avve_grec
ⲡⲟⲗⲗⲁⲕⲓⲥ	avve_grec
ⲡⲟⲟⲩ	avve_egiz
ⲡⲟⲟⲩⲛϩⲟⲟⲩ	avve_egiz
ⲡⲟⲥⲟⲙⲁⲗⲗⲟⲛ	avve_grec
ⲡⲟⲥⲱ	avve_grec
ⲡⲣⲟⲥⲟⲩⲕⲟⲩⲓ	avve_egiz
ⲡⲣⲟⲥⲟⲩⲟⲩⲛⲟⲩ	avve_egiz
ⲡⲣⲟⲥⲟⲩⲟⲩⲟⲉⲓϣ	avve_egiz
ⲡⲣⲟⲥⲟⲩⲟⲩⲟⲓϣ	avve_egiz
ⲡⲱⲥ	avve_grec
ⲥⲁⲃⲟⲗ	avve_egiz
ⲥⲁⲡⲓⲥⲁ	avve_egiz
ⲥⲁⲣⲕⲓⲕⲱⲥ	avve_grec
ⲥⲭⲉⲇⲟⲛ	avve_grec
ⲥⲭⲉⲇⲱⲛ	avve_grec
ⲧⲁⲓⲟⲛⲧⲉⲑⲉ	avve_egiz
ⲧⲁⲓⲧⲉⲑⲉ	avve_egiz
ⲧⲁⲭⲏ	avve_grec
ⲧⲉⲓϩⲉ	avve_egiz
ⲧⲉⲛⲟⲩ	avve_egiz
ⲧⲉⲣⲟⲙⲡⲉ	avve_egiz
ⲧⲉⲱⲥ	avve_grec
ⲧⲓϩⲉ	avve_egiz
ⲧⲟⲧⲉ	avve_grec
ⲧⲱⲛ	avve_egiz
ⲧⲱⲛⲟⲩ	avve_egiz
ⲫⲁⲛⲉⲣⲟⲛ	avve_grec
ⲫⲩⲥⲉⲓ	avve_grec
ⲧⲁⲣⲉ	trip_nomi
ⲙⲁⲣ	trip_pron
ⲙⲁⲣⲉ	trip_nomitrip_pron
ϣⲁⲛⲧ	tripsost_egiz_pron
ϣⲁⲛⲧⲉ	trip
ⲙⲉ	triptripsost_asso_egiz_femm_siplsost_verb_asso
ⲙⲡⲣⲧⲣⲉ
ⲛⲛⲉ	trip
ⲙⲡ	trip
ⲙⲡⲉ	tripinte_egiz
ⲙⲡⲉ	tripinte_egiz
ⲙⲡⲁⲧ	trip
ⲙⲡⲁⲧⲉ	trip
ⲉⲣⲉ	tripconv
ⲉϥⲉ	trip
ⲉⲓⲉ	tripinte_egiz
ⲉⲥⲉ	trip
ⲉⲩⲉ	trip
ⲛⲧⲉⲣ	trip
ⲛⲧⲉⲣⲉ	trip
ⲁ	fututrip
ⲁⲣ
ϩⲉⲛ	arinprep_nomi_egiz
ϭⲉ	cong_egiz
ⲕⲉ	sost_egiz_nomi
ⲙ	refe_dimo_artinegaprep_egiz_nomiattrsost_verb_asso
ⲛ	refe_partrefe_dimo_artinegatripconvprep_nomi_egizattrsost_verb_nomisost_verb_pron
ⲛⲉ	refe_dimo_artirefe_dimo_pronrefe_dimo_bipnconv
ⲟⲩ	refe_partarinsost_asso_egiz_mafe_sipl
ⲡ	refe_dimo_arti
ⲡⲉ	pleorefe_dimo_artirefe_dimo_pronrefe_dimo_bipnrefe_dimo_relasost_asso_egiz_femm_sipl
ⲧ	refe_partrefe_dimo_artirefe_dimo_pron
ⲧⲉ	refe_partrefe_dimo_artirefe_dimo_pronrefe_dimo_bipn
ⲩ	refe_partarin
ⲉⲛⲧⲉⲣ
ⲉ	trip_eyan_inizconv_circconv_relaconv_secoprep_nomi_egiz
ⲉⲣⲉ	tripconv
ⲉⲣ	sost_verb_nomi
ⲉⲣⲉ	tripconv
ⲉ	trip_eyan_inizconv_circconv_relaconv_secoprep_nomi_egiz
ⲛⲧ	convsost_verb_pron
ⲉⲣⲉ	tripconv
ⲉⲣ	sost_verb_nomi
ϩⲁⲙⲁ	cong_grec
ϩⲟⲧⲁⲛ	cong_grec
ϩⲱⲥ	cong_grec
ϩⲱⲥⲇⲉ	cong_grec
ϩⲱⲥⲧⲉ	cong_grec
ϫⲉ	cong_egizsost_verb_nomi
ϫⲉⲕⲁⲁⲥ
ϫⲉⲕⲁⲥ	cong_egiz
ϫⲉⲛⲙⲙⲟⲛ	cong_egiz
ϫⲓⲛⲙⲙⲟⲛ	cong_egiz
ϫⲓⲛⲧⲁ	cong_egiz
ϫⲛⲙⲙⲟⲛ	cong_egiz
ⲁⲗⲗⲁ	cong_grec
ⲁⲣⲁ	cong_grec
ⲁⲣⲏⲩ	cong_egiz
ⲁⲩⲱ	cong_egiz
ⲇⲓⲁⲧⲟⲩⲧⲟ	cong_grec
ⲉϣϫⲉ	cong_egiz
ⲉϣⲱⲡⲉ	cong_egiz
ⲉⲓⲙⲏⲧⲉⲓ	cong_grec
ⲉⲓⲙⲏⲧⲓ	cong_grec
ⲉⲓⲧⲁ	cong_grec
ⲉⲓⲧⲉ	cong_grec
ⲉⲛⲉ	tripconv
ⲉⲡⲉⲓ	cong_grec
ⲉⲡⲉⲓⲇⲏ	cong_grec
ⲉⲡⲓⲇⲏ	cong_grec
ⲉⲧⲃⲉⲡⲁⲓ	cong_egiz
ⲉⲧⲉⲛⲁⲓⲛⲉ	cong_egiz
ⲉⲧⲉⲡⲁⲓⲡⲉ	cong_egiz
ⲉⲧⲉⲧⲁⲓⲧⲉ	avve_egizcong_egiz
ⲉⲫⲟⲥⲟⲛ	cong_grec
ⲏ	cong_grec
ⲕⲁⲓ	cong_grec
ⲕⲁⲓⲅⲁⲣ	cong_grec
ⲕⲁⲓⲙⲏⲛ	cong_grec
ⲕⲁⲓⲡⲉⲣ	cong_grec
ⲕⲁⲓⲧⲟⲓ	cong_grec
ⲕⲁⲛ	cong_grec
ⲕⲁⲧⲁⲑⲉ	cong_egiz
ⲗⲟⲓⲡⲟⲛ	cong_grec
ⲙⲉⲛ	cong_grecesis
ⲙⲉⲛⲧⲟⲓⲅⲉ	cong_grec
ⲙⲏ	cong_grec
ⲙⲏⲉϣⲁϥ	cong_egiz
ⲙⲏⲡⲟⲧⲉ	cong_grec
ⲙⲏⲧⲉⲓ	cong_grec
ⲙⲏⲧⲓ	cong_grec
ⲙⲙⲟⲛ	cong_egiz
ⲙⲛⲛⲥⲁⲛⲁⲓ	cong_egiz
ⲙⲛⲧⲟⲓⲅⲉ	cong_grec
ⲙⲟⲛⲟⲛ	cong_grec
ⲛⲑⲉⲁⲛⲛ	cong_egiz
ⲛⲑⲉⲉⲧ	cong_egiz
ⲛⲑⲉⲉⲧⲉⲣⲉ	cong_egiz
ⲛⲥⲁⲃⲏⲗ	cong_egiz
ⲛⲥⲁⲃⲏⲗϫⲉ	cong_egiz
ⲟⲩⲅⲁⲣ	cong_grec
ⲟⲩⲇⲉ	cong_grec
ⲟⲩⲕⲟⲩⲛ	cong_grec
ⲟⲩⲙⲟⲛⲟⲛ	cong_grec
ⲟⲩⲙⲟⲛⲟⲛϫⲉ	cong_grec
ⲟⲩⲛ	cong_grecesis
ⲟⲩⲧⲉ	cong_grecprep_egiz_nomi
ⲡⲁⲗⲓⲛ	cong_grec
ⲡⲗⲏⲛ	cong_grec
ⲧⲁⲉⲓⲟⲛⲧⲉⲑⲉ	cong_egiz
ⲧⲁⲉⲓⲟⲛⲧⲉⲧϩⲉ	cong_egiz
ⲧⲁⲓⲟⲛⲧⲉⲧϩⲉ	cong_egiz
ⲛⲉ	refe_dimo_artirefe_dimo_pronrefe_dimo_bipnconv
ⲡⲉ	pleorefe_dimo_artirefe_dimo_pronrefe_dimo_bipnrefe_dimo_relasost_asso_egiz_femm_sipl
ⲧⲉ	refe_partrefe_dimo_artirefe_dimo_pronrefe_dimo_bipn
ⲛⲉ	refe_dimo_artirefe_dimo_pronrefe_dimo_bipnconv
ⲛⲉⲣⲉ	conv
ⲛⲉⲣ
ⲛⲉⲣⲉ	conv
ⲉ	trip_eyan_inizconv_circconv_relaconv_secoprep_nomi_egiz
ⲉⲛⲧ	convconv_seco
ⲉⲧ	conv
ⲉⲧⲉ	conv
ⲉⲧⲉⲣⲉ	conv
ⲛⲧ	convsost_verb_pron
ⲉⲧⲉⲣⲉ	conv
ⲙⲉⲛ	cong_grecesis
ⲙⲙⲛ	esis
ⲙⲙⲛⲧ	esis
ⲙⲛ	esisprep_nomi_egiz
ⲙⲛⲧ	esis
ⲙⲛⲧⲁ	esis
ⲙⲛⲧⲉ	esis
ⲟⲩⲛ	cong_grecesis
ⲟⲩⲛⲧ	esis
ⲟⲩⲛⲧⲁ	esis
ⲟⲩⲛⲧⲉ	esis
ⲟⲩⲛⲧⲏ	esis
ⲩⲛ	esis
ⲩⲛⲧ	esis
ⲩⲛⲧⲁ	esis
ⲩⲛⲧⲉ	esis
ⲁ	fututrip
ⲛⲁ	refe_dimo_possrefe_dimo_pronfutuprep_pron_egizsost_verb_asso
ϩⲱ	agge_assoagge_pronsost_verb_asso
ϩⲱⲱ	agge_pron
ⲙⲁⲩⲁⲁ	agge_pron
ⲙⲁⲩⲁⲁⲧ
ⲙⲙⲓⲛⲙⲙⲟ	agge_pron
ⲙⲙⲓⲛⲙⲙⲱ
ⲟⲩⲁⲁ	agge_pron
ⲟⲩⲁⲁⲧ
ⲧⲏⲣ	agge_pron
ⲙⲙⲓⲛⲙⲙⲟ	agge_pron
=ⲥⲙⲟⲩ=	sost_asso_egiz_masc_sipl
ϣϫⲉ	sost_asso_egiz_masc_sipl
ϣϫⲏⲩ	sost_asso_egiz_plur
ϣϭⲟⲙ	sost_verb_asso
ϣⲁϣ	sost_asso_egiz_masc_sipl
ϣⲁϥⲧⲉ	sost_asso_egiz_masc_sipl
ϣⲁϩ	sost_asso_egiz_masc_siplsost_verb_asso
ϣⲁϩⲛⲕⲱϩⲧ	sost_asso_egiz_masc_sipl
ϣⲁϩⲛⲥⲁⲧⲉ	sost_asso_egiz_masc_sipl
ϣⲁϫⲉ	sost_verb_asso
ϣⲁⲁϥ	sost_asso_egiz_masc_sipl
ϣⲁⲁⲛⲧ	sost_egiz_pron
ϣⲁⲁⲣ	sost_asso_egiz_masc_sipl
ϣⲁⲓⲣⲉ	sost_asso_egiz_femm_sipl
ϣⲁⲗⲛⲃⲏⲧ	sost_asso_egiz_masc_sipl
ϣⲁⲛϩⲏⲧ	sost_asso_egiz_mafe_sipl
ϣⲁⲛⲁϩⲧⲏϥ	sost_asso_egiz_mafe_sipl
ϣⲁⲛⲧ	tripsost_egiz_pron
ϣⲁⲥⲱⲛⲧ	sost_asso_egiz_masc_sipl
ϣⲁⲩ	sost_asso_egiz_masc_sipl
ϣⲃⲃⲓⲱ	sost_asso_egiz_femm_sipl
ϣⲃⲉ	sost_asso_egiz_masc_sipl
ϣⲃⲉⲉⲣ	sost_asso_egiz_femm_sing
ϣⲃⲏⲣ	sost_asso_egiz_mafe_sipl
ϣⲃⲏⲣⲕⲗⲏⲣⲟⲛⲟⲙⲟⲥ	sost_asso_egiz_mafe_sipl
ϣⲃⲣⲙⲉⲗⲟⲥ	sost_asso_egiz_mafe_sipl
ϣⲃⲣⲣϩⲱⲃ	sost_asso_egiz_mafe_sipl
ϣⲃⲱ	sost_asso_egiz_femm_sipl
ϣⲉ	sost_asso_egiz_mafe_sipl
ϣⲉⲉⲣⲉ	sost_asso_egiz_femm_sipl
ϣⲉⲗⲉⲉⲧ	sost_asso_egiz_femm_sipl
ϣⲉⲙⲁⲃⲧⲁⲥⲉⲛϣⲉ	nume
ϣⲉⲙⲛⲧϣⲉ	nume
ϣⲉⲛⲉⲗⲟⲟⲗⲉ	sost_asso_egiz_masc_sipl
ϣⲉⲧⲁⲓⲟⲩ	nume
ϣⲏⲓ	sost_asso_egiz_masc_sipl
ϣⲏⲛ	sost_asso_egiz_masc_sipl
ϣⲏⲣⲉ	sost_asso_egiz_masc_sipl
ϣⲏⲣⲉϣⲏⲙ	sost_asso_egiz_mafe_sipl
ϣⲏⲣⲉⲕⲟⲩⲓ	sost_asso_egiz_mafe_sipl
ϣⲏⲧ	sost_asso_egiz_masc_sipl
ϣⲓ	sost_asso_egiz_masc_sipl
ϣⲓⲏ	sost_asso_egiz_femm_sipl
ϣⲓⲡⲉ	sost_asso_egiz_masc_sipl
ϣⲕⲁⲕ
ϣⲕⲟⲗ	sost_asso_egiz_masc_sipl
ϣⲗⲟϥ	sost_asso_egiz_masc_sipl
ϣⲙⲙⲟ	sost_asso_egiz_mafe_sipl
ϣⲙⲟⲩⲛ	nume
ϣⲙⲟⲩⲛⲛϣⲟ	nume
ϣⲛⲉ	sost_asso_egiz_masc_sipl
ϣⲛⲏⲩ
ϣⲛⲥ	sost_asso_egiz_masc_sipl
ϣⲟ	nume
ϣⲟϣ	sost_asso_egiz_masc_sipl
ϣⲟϣⲧ	sost_asso_egiz_masc_sipl
ϣⲟϫⲛⲉ	sost_asso_egiz_masc_sipl
ϣⲟⲉⲓϣ	sost_asso_egiz_masc_sipl
ϣⲟⲉⲓϫ	sost_asso_egiz_masc_sipl
ϣⲟⲗⲉⲥ	sost_asso_egiz_masc_sipl
ϣⲟⲙⲉⲛⲧ	nume_spec
ϣⲟⲙⲉⲧ	nume_spec
ϣⲟⲙⲛⲧ	nume_spec
ϣⲟⲙⲧ	sost_asso_egiz_masc_sipl
ϣⲟⲙⲧⲉ	sost_asso_egiz_masc_siplsost_asso_egiz_masc_sipl
ϣⲟⲛϣ	sost_asso_egiz_masc_sipl
ϣⲟⲛⲧⲉ	sost_asso_egiz_femm_sipl
ϣⲟⲟⲥ	sost_asso_egiz_masc_sipl
ϣⲟⲟⲥⲉ	sost_asso_egiz_masc_sipl
ϣⲟⲣⲡ	sost_asso_egiz_masc_sipl
ϣⲟⲣⲡⲉ	sost_asso_egiz_masc_sipl
ϣⲟⲩ	sost_egiz_nomi
ϣⲟⲩϣⲧ	sost_asso_egiz_masc_sipl
ϣⲟⲩϩⲏⲛⲉ	sost_asso_egiz_mafe_sipl
ϣⲟⲩⲙⲉⲣⲓⲧ	sost_egiz_pron
ϣⲟⲩⲙⲟⲩⲧⲉ	sost_asso_egiz_mafe_sipl
ϣⲟⲩⲣⲡⲉⲥⲙⲉⲉⲩⲉ	sost_asso_egiz_femm_sipl
ϣⲟⲩⲧⲙⲧⲁⲩⲉ	sost_asso_egiz_mafe_sipl
ϣⲡⲉⲛϣⲱⲡ	sost_asso_egiz_masc_sipl
ϣⲡⲏⲣⲉ	sost_asso_egiz_femm_sipl
ϣⲣⲡⲙⲓⲥⲉ	sost_asso_egiz_mafe_sipl
ϣⲣⲡⲙⲙⲓⲥⲉ	sost_asso_egiz_mafe_sipl
ϣⲣⲡⲛ	sost_egiz_nomi
ϣⲥⲛⲕⲱⲣⲁⲝ	sost_asso_egiz_masc_sipl
ϣⲥⲛⲟⲩⲟϭⲉ	sost_asso_egiz_masc_sipl
ϣⲧⲉⲕⲟ	sost_asso_egiz_masc_sipl
ϣⲧⲏⲛ	sost_asso_egiz_masc_sipl
ϣⲧⲙⲟⲩⲱⲛ	sost_asso_egiz_masc_sipl
ϣⲱ	sost_asso_egiz_femm_sipl
ϣⲱⲙ	sost_asso_egiz_masc_sipl
ϣⲱⲙⲉ
ϣⲱⲥ	sost_asso_egiz_masc_sipl
ϣⲱⲥⲙ	sost_asso_egiz_masc_sipl
ϣⲱⲱⲧⲛⲉⲓⲇⲱⲗⲟⲛ	sost_asso_egiz_masc_sipl
ϥⲁⲓϣⲓⲛⲉ	sost_asso_egiz_mafe_sipl
ϥⲁⲓⲉⲧⲡⲱ	sost_asso_egiz_mafe_sipl
ϥⲁⲓⲕⲗⲟⲙ	sost_asso_egiz_mafe_sipl
ϥⲧⲟ	nume
ϥⲧⲟⲟⲩ	nume
ϥⲱ	sost_asso_egiz_masc_sipl
ϩⲁϩ	sost_asso_egiz_mafe_sipl
ϩⲁⲅⲓⲟⲥ	sost_grec_masc_sipl
ϩⲁⲅⲓⲟⲥⲩⲛⲏ	sost_grec_femm_sipl
ϩⲁⲅⲓⲟⲧⲁⲧⲟⲥ	sost_grec_masc_sipl
ϩⲁⲅⲓⲱⲥⲩⲛⲏ	sost_grec_femm_sipl
ϩⲁⲅⲓⲱⲧⲁⲧⲟⲥ	sost_grec_masc_sipl
ϩⲁⲉⲓⲃⲉⲥ	sost_asso_egiz_femm_sipl
ϩⲁⲉⲓⲃⲥ	sost_asso_egiz_femm_sipl
ϩⲁⲉⲓⲙ	sost_asso_egiz_masc_sipl
ϩⲁⲏ	sost_asso_egiz_femm_sipl
ϩⲁⲓ	sost_asso_egiz_masc_sipl
ϩⲁⲓⲃⲉⲥ	sost_asso_egiz_femm_sipl
ϩⲁⲓⲃⲥ	sost_asso_egiz_femm_sipl
ϩⲁⲓⲣⲁⲓⲧⲓⲕⲟⲥ	sost_grec_masc_sipl
ϩⲁⲓⲣⲉⲥⲓⲥ	sost_grec_femm_sipl
ϩⲁⲓⲣⲉⲧⲓⲕⲟⲥ	sost_grec_masc_sipl
ϩⲁⲓⲣⲏⲥⲓⲥ	sost_grec_femm_sipl
ϩⲁⲓⲣⲏⲧⲓⲕⲟⲥ	sost_grec_masc_sipl
ϩⲁⲕ	sost_asso_egiz_mafe_sipl
ϩⲁⲗⲁⲁⲧⲉ	sost_asso_egiz_plur
ϩⲁⲗⲁⲧⲉ	sost_asso_egiz_plur
ϩⲁⲗⲉ	sost_asso_egiz_femm_sipl
ϩⲁⲗⲏⲧ	sost_asso_egiz_masc_sipl
ϩⲁⲗⲱⲙ	sost_asso_egiz_masc_sipl
ϩⲁⲗⲱⲙⲁ	sost_grec_masc_sipl
ϩⲁⲙⲕⲉⲗⲗⲉ	sost_asso_egiz_masc_sipl
ϩⲁⲙⲕⲗⲗⲉ	sost_asso_egiz_masc_sipl
ϩⲁⲡ	sost_asso_egiz_masc_sipl
ϩⲁⲡⲗⲟⲩⲥ	sost_grec_masc_sipl
ϩⲁⲣϣϩⲏⲧ	sost_asso_egiz_mafe_sipl
ϩⲁⲣⲉϣϩⲏⲧ	sost_asso_egiz_mafe_sipl
ϩⲁⲣⲙⲁ	sost_grec_masc_sipl
ϩⲁⲣⲙⲉⲛⲓⲟⲥ	sost_grec_masc_sipl
ϩⲁⲣⲙⲏⲛⲓⲟⲥ	sost_grec_masc_sipl
ϩⲁⲥⲉ	sost_asso_egiz_masc_sipl
ϩⲁⲥⲓⲉ	sost_asso_egiz_femm_sipl
ϩⲁⲧ	sost_asso_egiz_masc_sipl
ϩⲁⲧⲃⲉⲥ	sost_asso_egiz_femm_sipl
ϩⲁⲧⲏⲣ	sost_asso_egiz_masc_sipl
ϩⲃⲁ	sost_asso_egiz_mafe_sipl
ϩⲃⲏⲟⲩⲉ	sost_asso_egiz_plur
ϩⲃⲏⲩⲉ	sost_asso_egiz_plur
ϩⲃⲟⲩⲣ	sost_asso_egiz_masc_sipl
ϩⲃⲥⲱ	sost_asso_egiz_femm_sipl
ϩⲉ	sost_asso_egiz_femm_siplsost_verb_asso
ϩⲉⲃⲇⲟⲙⲁⲥ	sost_grec_masc_sipl
ϩⲉⲃⲣⲁⲓⲟⲥ	sost_grec_masc_sipl
ϩⲉⲃⲥⲱ	sost_asso_egiz_femm_sipl
ϩⲉⲃⲱⲱⲛ	sost_asso_egiz_masc_sipl
ϩⲉⲅⲉⲙⲱⲛ	sost_grec_masc_sipl
ϩⲉⲅⲏⲙⲱⲛ	sost_grec_masc_sipl
ϩⲉⲑⲛⲟⲥ	sost_grec_masc_sipl
ϩⲉⲑⲟⲥ	sost_grec_masc_sipl
ϩⲉⲓⲉⲓⲃ	sost_asso_egiz_masc_sipl
ϩⲉⲓⲣⲉⲥⲓⲥ	sost_grec_femm_sipl
ϩⲉⲓⲣⲉⲧⲓⲕⲟⲥ	sost_grec_masc_sipl
ϩⲉⲓⲣⲏⲥⲓⲥ	sost_grec_femm_sipl
ϩⲉⲓⲣⲏⲧⲓⲕⲟⲥ	sost_grec_masc_sipl
ϩⲉⲗⲗⲏⲛ	sost_grec_masc_sipl
ϩⲉⲗⲡⲓⲥ	sost_grec_femm_sipl
ϩⲉⲙϩⲁⲗ	sost_asso_egiz_mafe_sipl
ϩⲉⲛⲉⲉⲧⲉ	sost_asso_egiz_femm_sipl
ϩⲉⲣⲙⲏⲛⲉⲩⲧⲏⲥ	sost_grec_masc_sipl
ϩⲉⲣⲙⲏⲛⲓⲁ	sost_grec_femm_sipl
ϩⲏ
ϩⲏⲃⲉ	sost_asso_egiz_masc_sipl
ϩⲏⲃⲥ	sost_asso_egiz_masc_sipl
ϩⲏⲅⲉⲙⲱⲛ	sost_grec_masc_sipl
ϩⲏⲅⲏⲙⲱⲛ	sost_grec_masc_sipl
ϩⲏⲇⲟⲛⲏ	sost_grec_femm_sipl
ϩⲏⲕⲉ	sost_asso_egiz_mafe_sipl
ϩⲏⲗⲏⲕⲓⲁ	sost_grec_femm_sipl
ϩⲏⲗⲓⲕⲓⲁ	sost_grec_femm_sipl
ϩⲏⲛⲉ	sost_asso_egiz_masc_sipl
ϩⲏⲡⲁⲣ	sost_grec_masc_sipl
ϩⲏⲧ	sost_asso_egiz_masc_siplsost_egiz_pron
ϩⲏⲧⲛⲟⲩⲱⲧ	sost_asso_egiz_masc_sipl
ϩⲏⲩ	sost_asso_egiz_masc_sipl
ϩⲓⲇⲓⲟⲛ	sost_grec_masc_sipl
ϩⲓⲇⲓⲱⲧⲏⲥ	sost_grec_masc_sipl
ϩⲓⲉⲓⲃ	sost_asso_egiz_masc_sipl
ϩⲓⲉⲓⲧ	sost_asso_egiz_masc_sipl
ϩⲓⲉⲣⲁϯⲟⲛ	sost_grec_masc_sipl
ϩⲓⲉⲣⲟⲛ	sost_grec_masc_sipl
ϩⲓⲉⲣⲟⲫⲁⲛⲧⲏⲥ	sost_grec_masc_sipl
ϩⲓⲏ	sost_asso_egiz_femm_sipl
ϩⲓⲕⲁⲛⲟⲥ	sost_grec_masc_sipl
ϩⲓⲕⲱⲛ	sost_grec_femm_sipl
ϩⲓⲟⲙⲉ	sost_asso_egiz_plur
ϩⲓⲟⲟⲩⲉ	sost_asso_egiz_plur
ϩⲓⲣ	sost_asso_egiz_masc_sipl
ϩⲓⲣⲏⲛⲉ	sost_grec_femm_sipl
ϩⲓⲣⲏⲛⲏ	sost_grec_femm_sipl
ϩⲓⲥⲁⲩⲣⲟⲥ	sost_grec_masc_sipl
ϩⲓⲥⲉ	sost_asso_egiz_masc_sipl
ϩⲓⲥⲟⲛ	sost_grec_masc_sipl
ϩⲓⲥⲧⲟⲣⲓⲁ	sost_grec_femm_sipl
ϩⲓⲥⲧⲱⲣⲓⲁ	sost_grec_femm_sipl
ϩⲗⲗⲏⲛ	sost_grec_masc_sipl
ϩⲗⲗⲟ	sost_asso_egiz_masc_siplsost_asso_egiz_masc_sipl
ϩⲗⲗⲱ	sost_asso_egiz_femm_sipl
ϩⲗⲟⲟⲗⲉ	sost_asso_egiz_masc_sipl
ϩⲙϩⲁⲗ	sost_asso_egiz_mafe_sipl
ϩⲙϫ	sost_asso_egiz_masc_sipl
ϩⲙⲉ	sost_asso_egiz_masc_sipl
ϩⲙⲏ	nume
ϩⲙⲟⲙ	qual
ϩⲙⲟⲧ	sost_asso_egiz_masc_sipl
ϩⲙⲟⲩ	sost_asso_egiz_masc_sipl
ϩⲛⲁ	verb_pron
ϩⲛⲁⲁⲩ	sost_asso_egiz_masc_sipl
ϩⲛⲁⲁⲩⲛⲕⲁⲥⲟⲧⲉ	sost_asso_egiz_masc_sipl
ϩⲛⲁⲩ
ϩⲛⲁⲩⲛⲕⲁⲥⲟⲧⲉ	sost_asso_egiz_masc_sipl
ϩⲛⲟ
ϩⲟ	sost_asso_egiz_masc_sipl
ϩⲟϥ	sost_asso_egiz_masc_sipl
ϩⲟⲃⲟⲗⲟⲥ	sost_grec_masc_sipl
ϩⲟⲉⲓⲙ	sost_asso_egiz_masc_sipl
ϩⲟⲉⲓⲛⲉ	sost_asso_egiz_plur
ϩⲟⲉⲓⲧⲉ	sost_asso_egiz_masc_sipl
ϩⲟⲓⲛⲉ	sost_asso_egiz_plur
ϩⲟⲓⲧⲉ	sost_asso_egiz_masc_sipl
ϩⲟⲗⲟⲕⲟⲧϯⲛⲟⲥ	sost_grec_masc_sipl
ϩⲟⲗⲟⲕⲟⲧⲧⲓⲛⲟⲥ	sost_grec_masc_sipl
ϩⲟⲗⲟⲥⲉⲣⲓⲕⲟⲛ	sost_grec_masc_sipl
ϩⲟⲙⲉⲗⲓⲁ	sost_grec_femm_sipl
ϩⲟⲙⲏⲗⲓⲁ	sost_grec_femm_sipl
ϩⲟⲙⲏⲣⲟⲥ	sost_grec_masc_sipl
ϩⲟⲙⲓⲗⲓⲁ	sost_grec_femm_sipl
ϩⲟⲙⲛⲧ	sost_asso_egiz_masc_sipl
ϩⲟⲙⲟⲗⲓⲁ	sost_grec_femm_sipl
ϩⲟⲙⲟⲗⲟⲅⲓⲁ	sost_grec_femm_sipl
ϩⲟⲙⲟⲛⲟⲓⲁ	sost_grec_femm_sipl
ϩⲟⲙⲟⲟⲩⲥⲓⲟⲛ	sost_grec_masc_sipl
ϩⲟⲙⲟⲟⲩⲥⲓⲟⲥ	sost_grec_masc_sipl
ϩⲟⲟⲩ	sost_asso_egiz_masc_siplqual
ϩⲟⲟⲩⲧ	sost_asso_egiz_masc_sipl
ϩⲟⲡⲗⲟⲛ	sost_grec_masc_sipl
ϩⲟⲣⲁⲙⲁ	sost_grec_masc_sipl
ϩⲟⲣⲙⲁⲕⲏ	sost_grec_femm_sipl
ϩⲟⲣⲙⲏ	sost_grec_femm_sipl
ϩⲟⲣⲟⲙⲁ	sost_grec_masc_sipl
ϩⲟⲣⲟⲥ	sost_grec_masc_sipl
ϩⲟⲧ	sost_asso_egiz_masc_sipl
ϩⲟⲧⲉ	sost_asso_egiz_femm_sipl
ϩⲟⲩⲉⲓⲧⲉ	sost_asso_egiz_femm_sipl
ϩⲟⲩⲙⲡⲉ	sost_asso_egiz_masc_sipl
ϩⲟⲩⲛ	sost_asso_egiz_masc_sipl
ϩⲟⲩⲟ	sost_asso_egiz_masc_sipl
ϩⲣⲁⲃⲃⲉⲓ	sost_grec_masc_sipl
ϩⲣⲁⲃⲃⲓ	sost_grec_masc_sipl
ϩⲣⲁⲃⲇⲟⲥ	sost_grec_masc_sipl
ϩⲣⲃ	sost_asso_egiz_masc_sipl
ϩⲣⲉ	sost_asso_egiz_masc_sipl
ϩⲣⲉⲙⲙⲁ	sost_asso_egiz_masc_sipl
ϩⲣⲏⲣⲉ	sost_asso_egiz_masc_sipl
ϩⲣⲏⲥⲓⲥ	sost_grec_femm_sipl
ϩⲣⲏⲧⲟⲛ	sost_grec_masc_sipl
ϩⲣⲏⲧⲱⲣ	sost_grec_masc_sipl
ϩⲣⲟⲕⲛϩⲏⲧ	sost_asso_egiz_masc_sipl
ϩⲣⲟⲟⲩ	sost_asso_egiz_masc_sipl
ϩⲣⲟⲩⲃⲃⲁⲓ	sost_asso_egiz_masc_sipl
ϩⲣⲱ	sost_asso_egiz_femm_sipl
ϩⲣⲱⲙⲁⲓⲟⲥ	sost_grec_masc_sipl
ϩⲣⲱⲙⲁⲓⲱⲥ	sost_grec_masc_sipl
ϩⲧⲏ	sost_egiz_pron
ϩⲧⲟ	sost_asso_egiz_masc_sipl
ϩⲧⲟⲟⲩⲉ	sost_asso_egiz_masc_sipl
ϩⲧⲟⲡ	sost_asso_egiz_masc_sipl
ϩⲧⲟⲣ	sost_asso_egiz_masc_sipl
ϩⲧⲱⲱⲣ	sost_asso_egiz_plur
ϩⲩⲗⲓⲕⲟⲛ	sost_grec_masc_sipl
ϩⲩⲡⲁⲣ	sost_grec_masc_sipl
ϩⲩⲡⲁⲣⲭⲟⲛⲧⲁ	sost_grec_masc_sipl
ϩⲩⲡⲉⲣⲏⲧⲏⲥ	sost_grec_masc_sipl
ϩⲩⲡⲟⲇⲓⲁⲕⲟⲛⲟⲥ	sost_grec_masc_sipl
ϩⲩⲡⲟⲕⲣⲓⲥⲓⲥ	sost_grec_femm_sipl
ϩⲩⲡⲟⲕⲣⲓⲧⲏⲥ	sost_grec_masc_sipl
ϩⲩⲡⲟⲙⲛⲏⲙⲁ	sost_grec_masc_sipl
ϩⲩⲡⲟⲙⲟⲛⲏ	sost_grec_femm_sipl
ϩⲩⲡⲟⲡⲟⲇⲓⲟⲛ	sost_grec_masc_sipl
ϩⲩⲡⲟⲥⲧⲁⲥⲓⲥ	sost_grec_femm_sipl
ϩⲩⲡⲟⲧⲁⲅⲏ	sost_grec_femm_sipl
ϩⲱⲃ	sost_asso_egiz_masc_sipl
ϩⲱⲃⲛⲓⲙ	sost_asso_egiz_masc_sing
ϩⲱⲥ	cong_grec
ϫⲁϫ	sost_asso_egiz_masc_sipl
ϫⲁϫⲉ	sost_asso_egiz_mafe_sipl
ϫⲁⲉⲓⲉ	sost_asso_egiz_masc_sipl
ϫⲁⲓⲉ	sost_asso_egiz_masc_sipl
ϫⲁⲓⲏ	sost_asso_egiz_masc_sipl
ϫⲁⲥⲓϩⲏⲧ	sost_asso_egiz_mafe_sipl
ϫⲁⲧϥⲉ	sost_asso_egiz_masc_sipl
ϫⲁⲧⲃⲉ	sost_asso_egiz_masc_sipl
ϫⲁⲩⲙⲟⲉⲓⲧ	sost_asso_egiz_mafe_sipl
ϫⲁⲩⲙⲟⲓⲧ	sost_asso_egiz_mafe_sipl
ϫⲉⲡ	adnu
ϫⲓϩ	sost_asso_egiz_masc_sipl
ϫⲓϫⲉⲉⲩⲉ	sost_asso_egiz_plur
ϫⲓϫⲉⲩⲉ	sost_asso_egiz_plur
ϫⲓϯ	sost_asso_egiz_masc_sipl
ϫⲓⲁⲉⲓⲕ	sost_asso_egiz_masc_sipl
ϫⲓⲕⲃⲁ	sost_asso_egiz_masc_sipl
ϫⲓⲛϭⲟⲛⲥ	sost_asso_egiz_masc_sipl
ϫⲛⲁⲁⲩ	sost_asso_egiz_masc_sipl
ϫⲟⲉⲓ
ϫⲟⲉⲓⲥ	sost_asso_egiz_mafe_sipl
ϫⲟⲉⲓⲧ	sost_asso_egiz_masc_sipl
ϫⲟⲓ	sost_asso_egiz_masc_sipl
ϫⲟⲟⲗⲉⲥ	sost_asso_egiz_femm_sipl
ϫⲟⲟⲩⲧ	sost_asso_egiz_masc_sipl
ϫⲟⲩⲥⲛⲟⲟⲩⲥ	nume
ϫⲟⲩⲧ	sost_asso_egiz_masc_sipl
ϫⲟⲩⲧⲁϥⲧⲉ	sost_asso_egiz_masc_sipl
ϫⲟⲩⲧⲏ	sost_asso_egiz_masc_sipl
ϫⲟⲩⲧⲥⲛⲟⲟⲩⲥ	nume
ϫⲟⲩⲱⲧⲉ	nume
ϫⲟⲩⲱⲧⲛϣⲉ	nume
ϫⲡ	adnu
ϫⲡⲟ	sost_verb_assosost_verb_pron
ϫⲣⲟⲡ	sost_asso_egiz_masc_sipl
ϫⲱ	sost_egiz_pronsost_verb_asso
ϫⲱϩⲙ	sost_verb_asso
ϫⲱⲱⲙⲉ	sost_asso_egiz_masc_sipl
ϭⲁⲙⲟⲩⲗ	sost_asso_egiz_masc_sipl
ϭⲃϣⲁ	sost_asso_egiz_masc_sipl
ϭⲃⲟⲉⲓ	sost_asso_egiz_masc_sipl
ϭⲃⲟⲓ	sost_asso_egiz_masc_sipl
ϭⲉⲗⲙⲁⲓ	sost_asso_egiz_masc_sipl
ϭⲉⲣⲁϭⲉ	sost_asso_egiz_plur
ϭⲉⲣⲱϥ	sost_asso_egiz_masc_sipl
ϭⲉⲣⲱⲃ	sost_asso_egiz_masc_sipl
ϭⲓϫ	sost_asso_egiz_femm_sipl
ϭⲓⲃⲱⲧⲟⲥ	sost_grec_femm_sipl
ϭⲓⲏⲛⲃⲁⲁⲙⲡⲉ	sost_asso_egiz_masc_sipl
ϭⲓⲙⲙⲟⲟϣⲉ	sost_asso_egiz_femm_sipl
ϭⲓⲛϣⲁϫⲉ	sost_asso_egiz_femm_sipl
ϭⲓⲛϣⲙϣⲉ	sost_asso_egiz_femm_sipl
ϭⲓⲛϩⲉ	sost_asso_egiz_femm_sipl
ϭⲓⲛϭⲱⲣ	sost_asso_egiz_masc_sipl
ϭⲓⲛⲃⲱⲕ	sost_asso_egiz_femm_sipl
ϭⲓⲛⲉⲓ	sost_asso_egiz_femm_sipl
ϭⲓⲛⲉⲣϩⲱⲃ	sost_asso_egiz_femm_sipl
ϭⲓⲛⲙⲓϣⲉ	sost_asso_egiz_mafe_sipl
ϭⲓⲛⲟⲩⲱⲙ	sost_asso_egiz_femm_sipl
ϭⲓⲛⲟⲩⲱⲱⲙ	sost_asso_egiz_femm_sipl
ϭⲓⲛⲣϩⲱⲃ	sost_asso_egiz_femm_sipl
ϭⲓⲛⲥϩⲁⲓ	sost_asso_egiz_femm_sipl
ϭⲓⲛⲥⲁⲁⲛϣ	sost_asso_egiz_femm_sipl
ϭⲓⲛⲥⲩⲛⲁⲅⲉ	sost_asso_egiz_femm_sipl
ϭⲓⲛⲥⲱ	sost_asso_egiz_femm_sipl
ϭⲓⲛⲱ	sost_asso_egiz_femm_sipl
ϭⲓⲛⲱϣ	sost_asso_egiz_femm_sipl
ϭⲓⲛⲱⲛϩ	sost_asso_egiz_femm_sipl
ϭⲗⲙⲁⲓ	sost_asso_egiz_masc_sipl
ϭⲗⲟⲙⲗⲉⲙ	sost_asso_egiz_masc_sipl
ϭⲗⲟⲙⲗⲙ	sost_asso_egiz_masc_sipl
ϭⲗⲟⲟϭⲉ	sost_asso_egiz_masc_sipl
ϭⲗⲟⲟⲧⲉ	sost_asso_egiz_plur
ϭⲗⲟⲧⲉ	sost_asso_egiz_plur
ϭⲗⲱⲱⲧ	sost_asso_egiz_masc_sipl
ϭⲟⲗ	sost_asso_egiz_masc_sipl
ϭⲟⲙ	sost_asso_egiz_masc_sipl
ϭⲟⲛⲥ	sost_asso_egiz_femm_sipl
ϭⲟⲟⲙ	sost_asso_egiz_plur
ϭⲟⲟⲙⲉ	sost_asso_egiz_masc_sipl
ϭⲟⲟⲩⲛⲉ	sost_asso_egiz_femm_sipl
ϭⲟⲣϭⲥ	sost_asso_egiz_femm_sipl
ϭⲟⲧ	sost_asso_egiz_masc_sipl
ϭⲣⲏⲡⲉ	sost_asso_egiz_femm_sipl
ϭⲣⲟϭ	sost_asso_egiz_masc_sipl
ϭⲣⲟⲙⲡⲉ	sost_asso_egiz_mafe_sipl
ϭⲣⲟⲛⲟⲥ	sost_grec_masc_sipl
ϭⲣⲟⲟϭ	sost_asso_egiz_masc_sipl
ϭⲣⲟⲟⲙⲡⲉ	sost_asso_egiz_masc_sipl
ϭⲣⲱϩ	sost_asso_egiz_masc_sipl
ϭⲱⲃ	sost_asso_egiz_masc_sipl
ϭⲱⲛⲧ	sost_asso_egiz_masc_sipl
ϯ	refe_partrefe_dimonumesost_verb_assosost_verb_nomi
ϯⲉ	nume
ϯⲙⲉ	sost_asso_egiz_masc_sipl
ϯⲟⲩ	nume
ϯⲟⲩⲛϣⲉ	nume
ϯⲟⲩⲛϣⲟ	nume
ϯⲡⲉ	sost_asso_egiz_masc_sipl
ϯⲣⲏⲛⲏ	sost_grec_femm_sipl
ϯⲧⲱⲛ	sost_asso_egiz_masc_sipl
ϯⲱⲧⲉ	sost_asso_egiz_femm_sipl
ⲁϣⲁϩⲟⲙ	sost_asso_egiz_masc_sipl
ⲁϣⲏ	sost_asso_egiz_masc_sipl
ⲁϣⲟⲉⲓϣ	sost_asso_egiz_mafe_sipl
ⲁϥ	sost_asso_egiz_masc_sipl
ⲁϩⲟⲣⲁⲧⲟⲥ	sost_grec_masc_sipl
ⲁϩⲱⲙ	sost_asso_egiz_masc_sipl
ⲁϩⲱⲱⲣ	sost_asso_egiz_plur
ⲁϭⲃⲉⲥ	sost_asso_egiz_femm_sipl
ⲁϭⲃⲥ	sost_asso_egiz_femm_sipl
ⲁϭⲣⲏⲛ	sost_asso_egiz_mafe_sipl
ⲁⲃⲃⲁ	sost_asso_egiz_masc_sipl
ⲁⲃⲟⲟⲩⲉ	sost_asso_egiz_plur
ⲁⲃⲱ	sost_asso_egiz_masc_sing
ⲁⲃⲱⲕ	sost_asso_egiz_masc_sipl
ⲁⲅⲁⲑⲟⲛ	sost_grec_masc_sipl
ⲁⲅⲁⲑⲟⲥ	sost_grec_masc_sipl
ⲁⲅⲁⲗⲙⲁ	sost_grec_masc_sipl
ⲁⲅⲁⲡⲏ	sost_grec_femm_sipl
ⲁⲅⲅⲉⲗⲟⲥ	sost_grec_masc_sipl
ⲁⲅⲅⲓⲟⲛ
ⲁⲅⲉⲗⲏ	sost_grec_femm_sipl
ⲁⲅⲉⲛⲛⲏⲧⲟⲥ	sost_grec_masc_sipl
ⲁⲅⲓⲟⲛ	sost_grec_masc_sipl
ⲁⲅⲙⲏ	sost_grec_femm_sipl
ⲁⲅⲟⲛⲓⲁ	sost_grec_femm_sipl
ⲁⲅⲟⲣⲁ	sost_grec_femm_sipl
ⲁⲅⲣⲓⲟⲛ	sost_grec_masc_sipl
ⲁⲅⲣⲓⲟⲥ	sost_grec_masc_sipl
ⲁⲅⲱⲅⲏ	sost_grec_femm_sipl
ⲁⲅⲱⲛ	sost_grec_masc_sipl
ⲁⲇⲓⲕⲟⲛ	sost_grec_masc_sipl
ⲁⲇⲓⲕⲟⲥ	sost_grec_masc_sipl
ⲁⲉⲓⲕ	sost_asso_egiz_masc_sipl
ⲁⲏⲣ	sost_grec_masc_sipl
ⲁⲑⲏⲧ	sost_asso_egiz_mafe_sipl
ⲁⲓⲛⲓⲅⲙⲁ	sost_grec_masc_sipl
ⲁⲓⲥⲑⲏⲧⲏⲣⲓⲟⲛ	sost_grec_masc_sipl
ⲁⲓⲧⲏⲙⲁ	sost_grec_masc_sipl
ⲁⲓⲧⲓⲁ	sost_grec_femm_sipl
ⲁⲓⲧⲓⲟⲥ	sost_grec_masc_sipl
ⲁⲓⲭⲙⲁⲗⲟⲧⲟⲥ	sost_grec_masc_sipl
ⲁⲓⲭⲙⲁⲗⲱⲥⲓⲁ	sost_grec_femm_sipl
ⲁⲓⲭⲙⲁⲗⲱⲧⲟⲥ	sost_grec_masc_sipl
ⲁⲓⲱⲛ	sost_grec_masc_sipl
ⲁⲓⲱⲛⲓⲟⲛ	sost_grec_masc_sipl
ⲁⲕⲁⲑⲁⲣⲥⲓⲁ	sost_grec_femm_sipl
ⲁⲕⲁⲑⲁⲣⲧⲟⲛ	sost_grec_masc_sipl
ⲁⲕⲁⲑⲁⲣⲧⲟⲥ	sost_grec_masc_sipl
ⲁⲕⲁⲓⲣⲟⲛ	sost_grec_masc_sipl
ⲁⲕⲓⲛⲏⲧⲟⲛ	sost_grec_masc_sipl
ⲁⲕⲣⲓⲃⲓⲁ	sost_grec_femm_sipl
ⲁⲕⲣⲓⲟⲛ	sost_grec_masc_sipl
ⲁⲕⲣⲟⲁⲧⲏⲥ	sost_grec_masc_sipl
ⲁⲕⲣⲱⲁⲧⲏⲥ	sost_grec_masc_sipl
ⲁⲕⲧⲓⲛ	sost_grec_masc_sipl
ⲁⲗⲉⲝⲁⲛⲇⲣⲉⲩⲥ	sost_grec_masc_sipl
ⲁⲗⲏⲑⲉⲓⲁ	sost_grec_femm_sipl
ⲁⲗⲏⲑⲓⲛⲏ	sost_grec_femm_sipl
ⲁⲗⲏⲑⲓⲛⲟⲛ	sost_grec_masc_sipl
ⲁⲗⲓⲑⲓⲛⲏ	sost_grec_femm_sipl
ⲁⲗⲕⲥ	sost_asso_egiz_masc_sipl
ⲁⲗⲟⲟⲩⲉ	sost_asso_egiz_plur
ⲁⲗⲟⲩ	sost_asso_egiz_mafe_sipl
ⲁⲙⲉⲗⲉⲓⲁ	sost_grec_femm_sipl
ⲁⲙⲉⲗⲓⲁ	sost_grec_femm_sipl
ⲁⲙⲛⲧⲉ	sost_asso_egiz_masc_sipl
ⲁⲛϩⲟⲗⲟⲙⲁ	sost_grec_masc_sipl
ⲁⲛϩⲟⲥⲓⲟⲥ	sost_grec_masc_sipl
ⲁⲛϫⲱϫ	sost_asso_egiz_plur
ⲁⲛⲁϣ	sost_asso_egiz_masc_sipl
ⲁⲛⲁⲅⲕⲁⲓⲟⲛ	sost_grec_masc_sipl
ⲁⲛⲁⲅⲕⲏ	sost_grec_femm_sipl
ⲁⲛⲁⲅⲛⲱⲥⲧⲏⲥ	sost_grec_masc_sipl
ⲁⲛⲁⲅⲛⲱⲥⲧⲓⲕⲟⲛ	sost_grec_masc_sipl
ⲁⲛⲁⲑⲉⲙⲁ	sost_grec_masc_sipl
ⲁⲛⲁⲑⲏⲙⲁ	sost_grec_masc_sipl
ⲁⲛⲁⲡⲁⲩⲥⲓⲥ	sost_grec_femm_sipl
ⲁⲛⲁⲥⲧⲁⲥⲓⲥ	sost_grec_femm_sipl
ⲁⲛⲁⲥⲧⲣⲟⲫⲏ	sost_grec_femm_sipl
ⲁⲛⲁⲫⲟⲣⲁ	sost_grec_femm_sipl
ⲁⲛⲁⲭⲱⲣⲏⲥⲓⲥ	sost_grec_masc_sipl
ⲁⲛⲁⲭⲱⲣⲏⲧⲏⲥ	sost_grec_masc_sipl
ⲁⲛⲁⲭⲱⲣⲓⲧⲏⲥ	sost_grec_masc_sipl
ⲁⲛⲇⲓⲕⲉⲓⲙⲉⲛⲟⲥ	sost_grec_masc_sipl
ⲁⲛⲇⲓⲕⲓⲙⲉⲛⲟⲥ	sost_grec_masc_sipl
ⲁⲛⲍⲏⲃ	sost_asso_egiz_femm_sipl
ⲁⲛⲍⲏⲃⲉ	sost_asso_egiz_femm_sipl
ⲁⲛⲛⲱⲛⲁ	sost_grec_femm_sipl
ⲁⲛⲟⲏⲧⲟⲥ	sost_grec_masc_sipl
ⲁⲛⲟⲙⲓⲁ	sost_grec_femm_sipl
ⲁⲛⲟⲙⲟⲛ	sost_grec_masc_sipl
ⲁⲛⲟⲙⲟⲥ	sost_grec_masc_sipl
ⲁⲛⲟⲭⲏ	sost_grec_femm_sipl
ⲁⲛⲧⲓϩⲣⲏⲥⲓⲥ	sost_grec_femm_sipl
ⲁⲛⲧⲓⲅⲣⲁⲫⲟⲛ	sost_grec_masc_sipl
ⲁⲛⲧⲓⲕⲉⲓⲙⲉⲛⲟⲥ	sost_grec_masc_sipl
ⲁⲛⲧⲓⲕⲓⲙⲉⲛⲟⲥ	sost_grec_masc_sipl
ⲁⲛⲧⲓⲗⲟⲅⲓⲁ	sost_grec_femm_sipl
ⲁⲛⲧⲓⲭⲣⲓⲥⲧⲟⲥ	sost_grec_masc_sipl
ⲁⲝⲓⲟⲥⲁⲝⲓⲟⲥⲁⲝⲓⲟⲥ	sost_grec_masc_sipl
ⲁⲝⲓⲱⲙⲁ	sost_grec_masc_sipl
ⲁⲝⲓⲱⲙⲁⲧⲓⲕⲟⲥ	sost_grec_masc_sipl
ⲁⲝⲟⲛ	sost_grec_masc_sipl
ⲁⲟⲩⲏⲧ	sost_asso_egiz_masc_sipl
ⲁⲡⲁ	sost_asso_egiz_masc_sipl
ⲁⲡⲁⲑⲏⲥ	sost_grec_masc_sipl
ⲁⲡⲁⲛⲧⲏⲙⲁ	sost_grec_masc_sipl
ⲁⲡⲁⲣⲭⲏ	sost_grec_femm_sipl
ⲁⲡⲁⲧⲏ	sost_grec_femm_sipl
ⲁⲡⲉ	sost_asso_egiz_femm_sipl
ⲁⲡⲉⲓⲗⲏ	sost_grec_femm_sipl
ⲁⲡⲏⲩⲉ	sost_asso_egiz_plur
ⲁⲡⲓⲥⲧⲓⲁ	sost_grec_femm_sipl
ⲁⲡⲓⲥⲧⲟⲛ	sost_grec_masc_sipl
ⲁⲡⲓⲥⲧⲟⲥ	sost_grec_masc_sipl
ⲁⲡⲟⲅⲣⲁⲫⲟⲛ	sost_grec_masc_sipl
ⲁⲡⲟⲅⲣⲩⲫⲟⲛ	sost_grec_masc_sipl
ⲁⲡⲟⲇⲉⲓⲝⲓⲥ	sost_grec_femm_sipl
ⲁⲡⲟⲇⲉⲝⲓⲥ	sost_grec_femm_sipl
ⲁⲡⲟⲇⲏⲅⲙⲁ	sost_grec_masc_sipl
ⲁⲡⲟⲕⲣⲁⲫⲟⲛ	sost_grec_masc_sipl
ⲁⲡⲟⲕⲣⲓⲥⲓⲥ	sost_grec_femm_sipl
ⲁⲡⲟⲕⲣⲩⲫⲟⲛ	sost_grec_masc_sipl
ⲁⲡⲟⲗⲁⲩⲥⲓⲥ	sost_grec_femm_sipl
ⲁⲡⲟⲗⲟⲅⲓⲁ	sost_grec_femm_sipl
ⲁⲡⲟⲥⲧⲟⲗⲓⲕⲏ	sost_grec_femm
ⲁⲡⲟⲥⲧⲟⲗⲓⲕⲟⲛ	sost_grec_masc_sipl
ⲁⲡⲟⲥⲧⲟⲗⲓⲕⲟⲥ	sost_grec_masc_sipl
ⲁⲡⲟⲥⲧⲟⲗⲟⲥ	sost_grec_masc_sipl
ⲁⲡⲟⲧ	sost_asso_egiz_masc_sipl
ⲁⲡⲟⲫⲁⲥⲓⲥ	sost_grec_femm_sipl
ⲁⲡⲣⲁⲅⲓⲁ	sost_grec_femm_sipl
ⲁⲣϣⲓⲛ	sost_asso_egiz_masc_sipl
ⲁⲣⲅⲟⲛ	sost_grec_masc_sipl
ⲁⲣⲉⲧⲏ	sost_grec_femm_sipl
ⲁⲣⲏⲃ	sost_asso_egiz_masc_sipl
ⲁⲣⲓⲁⲛⲟⲥ	sost_grec_masc_sipl
ⲁⲣⲓⲑⲙⲟⲥ	sost_grec_masc_sipl
ⲁⲣⲓⲕⲉ	sost_asso_egiz_masc_sipl
ⲁⲣⲓⲥⲧⲟⲛ	sost_grec_masc_sipl
ⲁⲣⲝ	sost_grec_masc_sipl
ⲁⲣⲟϣ	sost_asso_egiz_masc_sipl
ⲁⲣⲟⲟⲩⲉ	sost_asso_egiz_plur
ⲁⲣⲭⲁⲅⲅⲉⲗⲟⲥ	sost_grec_masc_sipl
ⲁⲣⲭⲁⲓⲟⲥ	sost_grec_masc_sipl
ⲁⲣⲭⲏ	sost_grec_femm_sipl
ⲁⲣⲭⲏⲅⲟⲥ	sost_grec_masc_sipl
ⲁⲣⲭⲏⲉⲡⲓⲥⲕⲟⲡⲟⲥ	sost_grec_masc_sipl
ⲁⲣⲭⲏⲙⲁⲛⲇⲣⲓⲧⲏⲥ	sost_grec_masc_sipl
ⲁⲣⲭⲏⲡⲣⲉⲥⲃⲩⲧⲉⲣⲟⲥ	sost_grec_masc_sipl
ⲁⲣⲭⲓⲇⲁⲓⲙⲱⲛ	sost_grec_masc_sipl
ⲁⲣⲭⲓⲇⲓⲁⲕⲟⲛⲟⲥ	sost_grec_masc_sipl
ⲁⲣⲭⲓⲉⲡⲓⲥⲕⲟⲡⲟⲥ	sost_grec_masc_sipl
ⲁⲣⲭⲓⲉⲣⲉⲩⲥ	sost_grec_masc_sipl
ⲁⲣⲭⲓⲉⲣⲟⲥⲩⲛⲏ	sost_grec_femm_sipl
ⲁⲣⲭⲓⲙⲁⲛⲇⲣⲓⲧⲏⲥ	sost_grec_masc_sipl
ⲁⲣⲭⲱⲛ	sost_grec_masc_sipl
ⲁⲥ	sost_asso_egiz_mafe_sipl
ⲁⲥⲉⲃⲏⲥ	sost_grec_masc_sipl
ⲁⲥⲑⲉⲛⲏⲥ	sost_grec_masc_sipl
ⲁⲥⲕⲏⲥⲓⲥ	sost_grec_femm_sipl
ⲁⲥⲕⲏⲧⲏⲥ	sost_grec_masc_sipl
ⲁⲥⲕⲏⲧⲓⲕⲟⲛ	sost_grec_masc_sipl
ⲁⲥⲕⲩⲧⲏⲥ	sost_grec_masc_sipl
ⲁⲥⲡⲉ	sost_asso_egiz_femm_sipl
ⲁⲥⲥⲩⲣⲓⲟⲥ	sost_grec_masc_sipl
ⲁⲥⲧⲉⲓⲟⲥ	sost_grec_masc_sipl
ⲁⲥⲧⲏⲣ	sost_grec_masc_sipl
ⲁⲥⲧⲣⲟⲗⲟⲅⲟⲥ	sost_grec_masc_sipl
ⲁⲥⲧⲣⲟⲛⲟⲙⲓⲁ	sost_grec_femm_sipl
ⲁⲥⲩⲛⲑⲉⲧⲟⲥ	sost_grec_masc_sipl
ⲁⲥⲭⲏⲙⲟⲥⲩⲛⲏ	sost_grec_femm_sipl
ⲁⲥⲱⲙⲁⲧⲟⲥ	sost_grec_masc_sipl
ⲁⲧϣⲁϫⲉ	sost_asso_egiz_mafe_sipl
ⲁⲧϣⲁⲩ	sost_asso_egiz_mafe_sipl
ⲁⲧϣⲉⲡϩⲙⲟⲧ	sost_asso_egiz_mafe_sipl
ⲁⲧϣⲓⲡⲉ	sost_asso_egiz_mafe_sipl
ⲁⲧϣⲓⲧ	sost_egiz_pron
ⲁⲧϣⲡϩⲓⲥⲉ	sost_asso_egiz_mafe_sipl
ⲁⲧϣⲡϩⲙⲟⲧ	sost_asso_egiz_mafe_sipl
ⲁⲧϩⲉⲃⲥⲱ	sost_asso_egiz_mafe_sipl
ⲁⲧϩⲏⲧ	sost_asso_egiz_mafe_sipl
ⲁⲧϩⲟⲧⲉ	sost_asso_egiz_mafe_sipl
ⲁⲧϫⲓⲏⲡⲉ	sost_asso_egiz_mafe_sipl
ⲁⲧϫⲟ	sost_egiz_pron
ⲁⲧϭⲟⲙ	sost_asso_egiz_mafe_sipl
ⲁⲧϭⲱⲛⲧ	sost_asso_egiz_mafe_sipl
ⲁⲧϯϣⲓ	sost_asso_egiz_mafe_sipl
ⲁⲧⲁⲕⲧⲟⲥ	sost_grec_masc_sipl
ⲁⲧⲁⲕⲧⲱⲥ	sost_grec_masc_sipl
ⲁⲧⲁⲣⲏϫ	sost_egiz_pron
ⲁⲧⲃⲉⲥ	sost_asso_egiz_femm_sipl
ⲁⲧⲃⲥ	sost_asso_egiz_femm_sipl
ⲁⲧⲃⲱⲗⲉⲃⲟⲗ	sost_asso_egiz_mafe_sipl
ⲁⲧⲉⲓⲙⲉ	sost_asso_egiz_mafe_sipl
ⲁⲧⲏⲡⲉ	sost_asso_egiz_mafe_sipl
ⲁⲧⲕⲁⲣⲡⲟⲥ	sost_grec_masc_sipl
ⲁⲧⲕⲓⲙ	sost_asso_egiz_mafe_sipl
ⲁⲧⲙⲟⲟⲩ	sost_asso_egiz_mafe_sipl
ⲁⲧⲙⲟⲩ	sost_asso_egiz_mafe_sipl
ⲁⲧⲛⲁ	sost_asso_egiz_mafe_sipl
ⲁⲧⲛⲁϩⲧⲉ	sost_asso_egiz_mafe_sipl
ⲁⲧⲛⲁⲩ	sost_asso_egiz_mafe_sipl
ⲁⲧⲛⲟⲃⲉ	sost_asso_egiz_mafe_sipl
ⲁⲧⲛⲟⲉⲓ	sost_asso_egiz_mafe_sipl
ⲁⲧⲛⲟⲩⲧⲉ	sost_asso_egiz_mafe_sipl
ⲁⲧⲟⲡⲟⲛ	sost_grec_masc_sipl
ⲁⲧⲟⲩⲉⲓⲛⲉ	sost_asso_egiz_mafe_sipl
ⲁⲧⲥⲃⲱ	sost_asso_egiz_mafe_sipl
ⲁⲧⲥⲟⲟⲩⲛ	sost_asso_egiz_mafe_sipl
ⲁⲧⲥⲱⲧⲙ	sost_asso_egiz_mafe_sipl
ⲁⲧⲧⲁϩⲟ	sost_asso_egiz_mafe_siplsost_egiz_pron
ⲁⲧⲧⲁⲕⲟ	sost_asso_egiz_mafe_sipl
ⲁⲧⲧⲁⲗϭⲟ	sost_asso_egiz_mafe_sipl
ⲁⲧⲧⲁⲩⲟ	sost_egiz_pron
ⲁⲧⲧⲛⲧⲱⲛ	sost_egiz_pron
ⲁⲧⲧⲱⲗⲙ	sost_asso_egiz_mafe_sipl
ⲁⲩⲁⲛ	sost_asso_egiz_masc_sipl
ⲁⲩⲅⲟⲩⲥⲧⲁⲗⲓⲟⲥ	sost_grec_masc_sipl
ⲁⲩⲅⲟⲩⲥⲧⲟⲥ	sost_grec_masc_sipl
ⲁⲩⲏⲧ	sost_asso_egiz_masc_sipl
ⲁⲩⲗⲏ	sost_grec_femm_sipl
ⲁⲩⲧⲟⲅⲉⲛⲏⲥ	sost_grec_masc_sipl
ⲁⲩⲧⲱⲕⲣⲁⲧⲱⲣ	sost_grec_masc_sipl
ⲁⲫⲉⲗⲗⲏⲥ	sost_grec_masc_sipl
ⲁⲫⲟⲣⲙⲏ	sost_grec_femm_sipl
ⲁⲫⲩⲗⲗⲏⲥ	sost_grec_masc_sipl
ⲃⲁϣⲟⲣ	sost_asso_egiz_mafe_sipl
ⲃⲁϣⲟⲩⲣ	sost_asso_egiz_femm_sipl
ⲃⲁⲁⲙⲡⲉ	sost_asso_egiz_mafe_sipl
ⲃⲁⲃⲉⲣⲱⲙⲉ	sost_asso_egiz_mafe_sipl
ⲃⲁⲓϣⲓⲛⲉ	sost_asso_egiz_mafe_sipl
ⲃⲁⲕⲧⲏⲣⲓⲁ	sost_grec_femm_sipl
ⲃⲁⲗ	sost_asso_egiz_masc_sipl
ⲃⲁⲗϩⲏⲧ	sost_asso_egiz_mafe_sipl
ⲃⲁⲗⲟⲧ	sost_asso_egiz_femm_sipl
ⲃⲁⲙⲡⲉ	sost_asso_egiz_mafe_sipl
ⲃⲁⲛⲓⲡⲉ	sost_asso_egiz_masc_sipl
ⲃⲁⲡϯⲥⲙⲁ	sost_grec_masc_sipl
ⲃⲁⲡϯⲥⲧⲏⲣⲓⲟⲛ	sost_grec_masc_sipl
ⲃⲁⲡⲧⲏⲥⲧⲏⲥ	sost_grec_masc_sipl
ⲃⲁⲡⲧⲓⲥⲙⲁ	sost_grec_masc_sipl
ⲃⲁⲡⲧⲓⲥⲧⲏⲣⲓⲟⲛ	sost_grec_masc_sipl
ⲃⲁⲡⲧⲓⲥⲧⲏⲥ	sost_grec_masc_sipl
ⲃⲁⲣⲃⲁⲣⲟⲥ	sost_grec_masc_sipl
ⲃⲁⲣⲃⲁⲣⲟⲩⲥ	sost_grec_masc_sipl
ⲃⲁⲣⲱⲧ	sost_asso_egiz_masc_sipl
ⲃⲁⲥⲁⲛⲟⲥ	sost_grec_masc_sipl
ⲃⲁⲥⲓⲥ	sost_grec_femm_sipl
ⲃⲉⲕⲉ	sost_asso_egiz_masc_sipl
ⲃⲉⲕⲏ	sost_asso_egiz_masc_sipl
ⲃⲉⲗϫⲉ	sost_asso_egiz_femm_sipl
ⲃⲉⲗⲃⲓⲗⲉ	sost_asso_egiz_femm_sipl
ⲃⲉⲛⲓⲡⲉ	sost_asso_egiz_masc_sipl
ⲃⲉⲣⲉⲇⲁⲣⲓⲟⲥ	sost_grec_masc_sipl
ⲃⲏⲙⲁ	sost_grec_masc_sipl
ⲃⲓⲕⲧⲱⲣⲓⲁ	sost_grec_femm_sipl
ⲃⲓⲟⲥ	sost_grec_masc_sipl
ⲃⲓⲣ	sost_asso_egiz_masc_sipl
ⲃⲓⲱⲧⲓⲕⲟⲥ	sost_grec_masc_sipl
ⲃⲗϫⲉ	sost_asso_egiz_femm_sipl
ⲃⲗⲁⲥⲫⲏⲙⲓⲁ	sost_grec_femm_sipl
ⲃⲗⲃⲓⲗⲉ	sost_asso_egiz_femm_sipl
ⲃⲗⲗⲉ	sost_asso_egiz_mafe_sipl
ⲃⲟⲏⲑⲉⲓⲁ	sost_grec_femm_sipl
ⲃⲟⲏⲑⲟⲥ	sost_grec_masc_sipl
ⲃⲟⲗ	sost_asso_egiz_masc_siplsost_verb_pron
ⲃⲟⲛⲧⲉ	sost_asso_egiz_femm_sipl
ⲃⲟⲧⲉ	sost_asso_egiz_masc_sipl
ⲃⲟⲩⲗⲉⲩⲧⲏⲣⲓⲟⲛ	sost_grec_masc_sipl
ⲃⲟⲩⲗⲉⲩⲧⲏⲥ	sost_grec_masc_sipl
ⲃⲟⲩⲛⲟⲥ	sost_grec_masc_sipl
ⲃⲣⲣⲉ	sost_asso_egiz_mafe_sipl
ⲃⲱⲓⲑⲓⲁ	sost_grec_femm_sipl
ⲃⲱⲛⲉⲗⲟⲟⲗⲉ	sost_asso_egiz_femm_sing
ⲃⲱⲛⲕⲛⲧⲉ	sost_asso_egiz_femm_sipl
ⲅⲁⲅⲅⲣⲁⲓⲛⲁ	sost_grec_masc_sipl
ⲅⲁⲍⲟⲫⲩⲗⲁⲅⲓⲟⲛ	sost_grec_masc_sipl
ⲅⲁⲍⲟⲫⲩⲗⲁⲕⲓⲟⲛ	sost_grec_masc_sipl
ⲅⲁⲗⲉⲓⲗⲁⲓⲟⲥ	sost_grec_masc_sipl
ⲅⲁⲗⲓⲗⲁⲓⲟⲥ	sost_grec_masc_sipl
ⲅⲁⲙⲟⲥ	sost_grec_masc_sipl
ⲅⲁⲛⲟⲛ	sost_grec_masc_sipl
ⲅⲉϩⲉⲛⲛⲁ	sost_grec_femm_sipl
ⲅⲉⲛⲉⲁ	sost_grec_femm_sipl
ⲅⲉⲛⲉⲥⲓⲥ	sost_grec_femm_sipl
ⲅⲉⲛⲏⲙⲁ	sost_grec_masc_sipl
ⲅⲉⲛⲓⲁ	sost_grec_femm_sipl
ⲅⲉⲛⲛⲁⲓⲟⲥ	sost_grec_masc_sipl
ⲅⲉⲛⲛⲏⲧⲟⲥ	sost_grec_masc_sipl
ⲅⲉⲛⲟⲥ	sost_grec_masc_sipl
ⲅⲉⲟⲙⲏⲉⲧⲣⲓⲁ	sost_grec_masc_sipl
ⲅⲉⲟⲙⲏⲧⲣⲓⲁ	sost_grec_femm_sipl
ⲅⲉⲱⲙⲏⲧⲣⲓⲁ	sost_grec_femm_sipl
ⲅⲓⲅⲁⲥ	sost_grec_masc_sipl
ⲅⲗⲱⲥⲥⲟⲕⲟⲙⲟⲛ	sost_grec_masc_sipl
ⲅⲛⲱⲙⲏ	sost_grec_femm_sipl
ⲅⲛⲱⲥⲧⲓⲕⲟⲥ	sost_grec_masc_sipl
ⲅⲣⲁⲙⲙⲁϯⲕⲟⲥ	sost_grec_masc_sipl
ⲅⲣⲁⲙⲙⲁⲧⲉⲩⲥ	sost_grec_masc_sipl
ⲅⲣⲁⲙⲙⲁⲧⲓⲕⲟⲥ	sost_grec_masc_sipl
ⲅⲣⲁⲫⲏ	sost_grec_femm_sipl
ⲅⲣⲏⲅⲟⲣⲟⲥ	sost_grec_masc_sipl
ⲅⲩⲙⲛⲁⲥⲓⲁ	sost_grec_femm_sipl
ⲇⲁⲓⲙⲟⲛⲓⲟⲛ	sost_grec_masc_sipl
ⲇⲁⲓⲙⲱⲛ	sost_grec_masc_sipl
ⲇⲁⲓⲙⲱⲛⲓⲟⲛ	sost_grec_masc_sipl
ⲇⲉⲓⲡⲛⲟⲛ	sost_grec_masc_sipl
ⲇⲉⲕⲁⲛⲟⲥ	sost_grec_masc_sipl
ⲇⲉⲩⲧⲉⲣⲟⲛⲟⲙⲓⲟⲛ	sost_grec_masc_sipl
ⲇⲏⲙⲁⲅⲱⲅⲟⲥ	sost_grec_masc_sipl
ⲇⲏⲙⲓⲟⲩⲣⲅⲓⲁ	sost_grec_femm_sipl
ⲇⲏⲙⲓⲟⲩⲣⲅⲟⲥ	sost_grec_masc_sipl
ⲇⲏⲙⲟⲥ	sost_grec_masc_sipl
ⲇⲏⲙⲟⲥⲓⲁ	sost_grec_femm_sipl
ⲇⲏⲙⲟⲥⲓⲟⲛ	sost_grec_masc_sipl
ⲇⲏⲙⲟⲧⲓⲥⲧⲏⲥ	sost_grec_masc_sipl
ⲇⲓⲁⲇⲟⲭⲟⲥ	sost_grec_masc_sipl
ⲇⲓⲁⲑⲏⲕⲏ	sost_grec_femm_sipl
ⲇⲓⲁⲑⲩⲕⲏ	sost_grec_femm_sipl
ⲇⲓⲁⲕⲟⲛⲓⲁ	sost_grec_femm_sipl
ⲇⲓⲁⲕⲟⲛⲟⲥ	sost_grec_masc_sipl
ⲇⲓⲁⲕⲣⲏⲥⲓⲥ	sost_grec_femm_sipl
ⲇⲓⲁⲕⲣⲓⲥⲓⲥ	sost_grec_femm_sipl
ⲇⲓⲁⲕⲣⲓⲧⲓⲕⲟⲥ	sost_grec_masc_sipl
ⲇⲓⲁⲕⲱⲛ	sost_grec_masc_sipl
ⲇⲓⲁⲗⲟⲅⲟⲥ	sost_grec_masc_sipl
ⲇⲓⲁⲥⲧⲏⲙⲁ	sost_grec_masc_sipl
ⲇⲓⲁⲧⲟⲭⲟⲥ	sost_grec_masc_sipl
ⲇⲓⲁⲫⲟⲣⲁ	sost_grec_femm_sipl
ⲇⲓⲁⲯⲁⲗⲙⲁ	sost_grec_masc_sipl
ⲇⲓⲇⲁⲥⲕⲁⲗⲓⲁ	sost_grec_femm_sipl
ⲇⲓⲏⲅⲏⲙⲁ	sost_grec_masc_sipl
ⲇⲓⲏⲅⲏⲥⲓⲥ	sost_grec_femm_sipl
ⲇⲓⲏⲕⲏⲥⲓⲥ	sost_grec_femm_sipl
ⲇⲓⲕⲁⲓⲟⲛ	sost_grec_masc_sipl
ⲇⲓⲕⲁⲓⲟⲥ	sost_grec_masc_sipl
ⲇⲓⲕⲁⲓⲟⲥⲩⲛⲏ	sost_grec_femm_sipl
ⲇⲓⲕⲁⲥⲧⲏⲣⲓⲟⲛ	sost_grec_masc_sipl
ⲇⲓⲕⲁⲥⲧⲏⲥ	sost_grec_masc_sipl
ⲇⲓⲕⲏ	sost_asso_egiz_femm_sipl
ⲇⲓⲙⲟⲧⲓⲥⲧⲏⲥ	sost_grec_masc_sipl
ⲇⲓⲟⲅⲙⲟⲥ	sost_grec_masc_sipl
ⲇⲓⲟⲓⲕⲏⲥⲓⲥ	sost_grec_femm_sipl
ⲇⲓⲡⲗⲟⲩⲛ	sost_grec_masc_sipl
ⲇⲓⲱⲅⲙⲟⲥ	sost_grec_masc_sipl
ⲇⲓⲱⲕⲧⲏⲥ	sost_grec_masc_sipl
ⲇⲟⲅⲙⲁ	sost_grec_masc_sipl
ⲇⲟⲕⲓⲙⲁⲥⲧⲏⲥ	sost_grec_masc_sipl
ⲇⲟⲩⲝ	sost_grec_masc_sipl
ⲇⲣⲁⲕⲱⲛ	sost_grec_masc_sipl
ⲇⲣⲟⲙⲟⲥ	sost_grec_masc_sipl
ⲇⲩⲙⲓⲟⲩⲣⲅⲟⲥ	sost_grec_masc_sipl
ⲇⲩⲙⲟⲥ	sost_grec_masc_sipl
ⲇⲩⲛⲁⲙⲓⲥ	sost_grec_femm_sipl
ⲇⲩⲛⲁⲧⲟⲥ	sost_grec_masc_sipl
ⲇⲩⲣⲁⲛⲛⲟⲥ	sost_grec_masc_sipl
ⲇⲱⲣⲉⲁ	sost_grec_femm_sipl
ⲇⲱⲣⲟⲛ	sost_grec_masc_sipl
ⲉϣⲁⲩ	sost_asso_egiz_plur
ⲉϣⲱ	sost_asso_egiz_femm_sipl
ⲉϩⲉ	sost_asso_egiz_masc_sipl
ⲉϩⲧⲱⲱⲣ	sost_asso_egiz_plur
ⲉϫⲏⲩ	sost_asso_egiz_plur
ⲉϭⲱϣ	sost_asso_egiz_mafe_sipl
ⲉϭⲱⲱϣ	sost_asso_egiz_mafe_sipl
ⲉⲃⲓⲏⲛ	sost_asso_egiz_mafe_sipl
ⲉⲃⲓⲱ	sost_asso_egiz_masc_sipl
ⲉⲃⲟⲧ	sost_asso_egiz_masc_sipl
ⲉⲃⲣⲁ	sost_asso_egiz_masc_sipl
ⲉⲃⲣⲏϭⲉ	sost_asso_egiz_femm_sipl
ⲉⲅⲕⲣⲁⲧⲏⲥ	sost_grec_masc_sipl
ⲉⲅⲕⲱⲙⲓⲟⲛ	sost_grec_masc_sipl
ⲉⲓϥⲧ	sost_asso_egiz_masc_sipl
ⲉⲓⲁ	sost_asso_egiz_masc_sipl
ⲉⲓⲁⲃⲉ	sost_asso_egiz_femm_sipl
ⲉⲓⲁⲗ	sost_asso_egiz_femm_sipl
ⲉⲓⲇⲟⲥ	sost_grec_masc_sipl
ⲉⲓⲇⲱⲗⲟⲛ	sost_grec_masc_sipl
ⲉⲓⲉⲃⲧ	sost_asso_egiz_masc_sipl
ⲉⲓⲉⲓⲃ	sost_asso_egiz_masc_sipl
ⲉⲓⲉⲡⲛⲟⲩⲃ	sost_asso_egiz_masc_sipl
ⲉⲓⲉⲡⲥⲁ	sost_asso_egiz_masc_sipl
ⲉⲓⲉⲣⲟ	sost_asso_egiz_masc_sipl
ⲉⲓⲟⲙ	sost_asso_egiz_masc_sipl
ⲉⲓⲟⲟⲣ	sost_asso_egiz_masc_sipl
ⲉⲓⲟⲟⲧⲉ	sost_asso_egiz_plur
ⲉⲓⲟⲡⲉ	sost_asso_egiz_masc_sipl
ⲉⲓⲟⲧⲉ	sost_asso_egiz_plur
ⲉⲓⲟⲩⲗ	sost_asso_egiz_mafe_sipl
ⲉⲓⲣⲏⲛⲏ	sost_grec_femm_sipl
ⲉⲓⲣⲏⲛⲏⲕⲟⲛ	sost_grec_masc_sipl
ⲉⲓⲣⲏⲛⲓⲕⲟⲛ	sost_grec_masc_sipl
ⲉⲓⲣⲣⲱⲟⲩ	sost_asso_egiz_plur
ⲉⲓⲧⲛ	sost_asso_egiz_masc_sipl
ⲉⲓⲱ	sost_asso_egiz_mafe_sipl
ⲉⲓⲱϩⲉ	sost_asso_egiz_masc_sipl
ⲉⲓⲱⲣⲉ	sost_asso_egiz_plur
ⲉⲓⲱⲧ	sost_asso_egiz_masc_sing
ⲉⲓⲱⲧⲉ	sost_asso_egiz_femm_sipl
ⲉⲕⲓⲃⲉ	sost_asso_egiz_femm_sipl
ⲉⲕⲕⲗⲏⲥⲓⲁ	sost_grec_femm_sipl
ⲉⲕⲕⲗⲏⲥⲓⲁⲥⲧⲓⲕⲟⲛ	sost_grec_masc_sipl
ⲉⲕⲕⲗⲩⲥⲓⲁ	sost_grec_femm_sipl
ⲉⲕⲗⲟⲅⲓⲥⲧⲓⲁ	sost_grec_femm_sipl
ⲉⲕⲥⲧⲁⲥⲓⲥ	sost_grec_femm_sipl
ⲉⲗⲁⲭⲉⲓⲥⲧⲟⲛ	sost_grec_masc_sipl
ⲉⲗⲁⲭⲓⲥⲧⲟⲛ	sost_grec_masc_sipl
ⲉⲗⲁⲭⲓⲥⲧⲟⲥ	sost_grec_masc_sipl
ⲉⲗⲕⲥϣⲁ	sost_asso_egiz_masc_sipl
ⲉⲗⲗⲏⲃ	sost_asso_egiz_masc_sipl
ⲉⲗⲗⲟⲅⲓⲙⲟⲥ	sost_grec_masc_sipl
ⲉⲗⲟⲟⲗⲉ	sost_asso_egiz_masc_sipl
ⲉⲙϩⲓⲧ	sost_asso_egiz_masc_sipl
ⲉⲙⲉⲛⲧ	sost_asso_egiz_masc_sipl
ⲉⲙⲏϣ	sost_asso_egiz_masc_sipl
ⲉⲙⲛⲧ	sost_asso_egiz_masc_sipl
ⲉⲙⲡⲟⲣⲟⲥ	sost_grec_masc_sipl
ⲉⲛⲉϩ	sost_asso_egiz_masc_sipl
ⲉⲛⲉⲣⲅⲉⲓⲁ	sost_grec_femm_sipl
ⲉⲛⲉⲣⲅⲓⲁ	sost_grec_femm_sipl
ⲉⲛⲟⲭⲟⲥ	sost_grec_masc_sipl
ⲉⲛⲧⲏϭ	sost_asso_egiz_masc_sipl
ⲉⲛⲧⲟⲗⲏ	sost_grec_femm_sipl
ⲉⲝⲉⲅⲏⲥⲓⲥ	sost_grec_femm_sipl
ⲉⲝⲏⲅⲏⲥⲓⲥ	sost_grec_femm_sipl
ⲉⲝⲏⲅⲓⲥⲓⲥ	sost_grec_femm_sipl
ⲉⲝⲟⲇⲟⲥ	sost_grec_masc_sipl
ⲉⲝⲟⲣⲏⲥⲧⲓⲁ	sost_grec_femm_sipl
ⲉⲝⲟⲣⲓⲥⲧⲓⲁ	sost_grec_femm_sipl
ⲉⲝⲟⲩⲥⲓⲁ	sost_grec_femm_sipl
ⲉⲝⲱⲣⲏⲥⲧⲓⲁ	sost_grec_femm_sipl
ⲉⲝⲱⲣⲓⲥⲧⲓⲁ	sost_grec_femm_sipl
ⲉⲟⲟⲩ	sost_asso_egiz_masc_sipl
ⲉⲡⲁⲣⲭⲓⲁ	sost_grec_femm_sipl
ⲉⲡⲁⲣⲭⲟⲥ	sost_grec_masc_sipl
ⲉⲡⲉⲓⲑⲩⲙⲓⲁ	sost_grec_femm_sipl
ⲉⲡⲏⲑⲩⲙⲓⲁ	sost_grec_femm_sipl
ⲉⲡⲏⲧⲏⲙⲓⲁ	sost_grec_femm_sipl
ⲉⲡⲓⲃⲟⲗⲏ	sost_grec_femm_sipl
ⲉⲡⲓⲑⲩⲙⲓⲁ	sost_grec_femm_siplsost_grec_femm_sipl
ⲉⲡⲓⲥⲕⲟⲡⲏ	sost_grec_masc_sipl
ⲉⲡⲓⲥⲕⲟⲡⲓⲟⲛ	sost_grec_masc_sipl
ⲉⲡⲓⲥⲕⲟⲡⲟⲥ	sost_grec_masc_sipl
ⲉⲡⲓⲥⲧⲏⲙⲏ	sost_grec_femm_sipl
ⲉⲡⲓⲥⲧⲟⲗⲏ	sost_grec_femm_sipl
ⲉⲡⲓⲧⲓⲙⲓⲁ	sost_grec_femm_sipl
ⲉⲡⲓⲧⲣⲟⲡⲟⲥ	sost_grec_masc_sipl
ⲉⲡⲣⲁ	sost_asso_egiz_mafe_sipl
ⲉⲣⲅⲁⲥⲓⲁ	sost_grec_femm_sipl
ⲉⲣⲅⲁⲧⲏⲥ	sost_grec_masc_sipl
ⲉⲣⲏⲙⲟⲥ	sost_grec_femm_sipl
ⲉⲣⲣⲱⲟⲩ	sost_asso_egiz_plur
ⲉⲣⲩⲑⲣⲁ	sost_grec_femm_sipl
ⲉⲣⲱⲟⲩ	sost_asso_egiz_plur
ⲉⲣⲱⲧⲉ	sost_asso_egiz_masc_sipl
ⲉⲥⲟⲟⲩ	sost_asso_egiz_masc_sipl
ⲉⲥⲩⲭⲓⲁ	sost_grec_femm_sipl
ⲉⲧⲉϩⲛⲁ	sost_asso_egiz_masc_sipl
ⲉⲧⲓⲟⲥ	sost_grec_masc_sipl
ⲉⲧⲡⲱ	sost_asso_egiz_masc_sipl
ⲉⲩⲁⲅⲅⲉⲗⲓⲟⲛ	sost_grec_masc_sipl
ⲉⲩⲁⲅⲅⲉⲗⲓⲥⲧⲏⲥ	sost_grec_masc_sipl
ⲉⲩⲅⲉⲛⲏⲥ	sost_grec_masc_sipl
ⲉⲩⲕⲧⲏⲣⲓⲟⲛ	sost_grec_masc_sipl
ⲉⲩⲗⲁⲃⲉⲓⲁ	sost_grec_femm_sipl
ⲉⲩⲗⲁⲃⲏⲥ	sost_grec_masc_sipl
ⲉⲩⲗⲁⲃⲓⲁ	sost_grec_femm_sipl
ⲉⲩⲥⲉⲃⲏⲥ	sost_grec_masc_sipl
ⲉⲩⲧⲏⲗⲉⲥ	sost_grec_masc_sipl
ⲉⲩⲫⲣⲟⲥⲩⲛⲏ	sost_grec_femm_sipl
ⲉⲩⲱ	sost_asso_egiz_masc_sipl
ⲍⲏⲧⲏⲙⲁ	sost_grec_masc_sipl
ⲍⲏⲧⲏⲥⲓⲥ	sost_grec_femm_sipl
ⲍⲟⲇⲓⲟⲛ	sost_grec_masc_sipl
ⲍⲱⲇⲓⲟⲛ	sost_grec_masc_sipl
ⲍⲱⲟⲛ	sost_grec_masc_sipl
ⲏⲉⲓ
ⲏⲓ	sost_asso_egiz_masc_sipl
ⲏⲡⲉ	sost_asso_egiz_femm_sipl
ⲏⲣⲡ	sost_asso_egiz_masc_sipl
ⲏⲥⲩⲭⲓⲁ	sost_grec_femm_sipl
ⲑⲁⲃ	sost_asso_egiz_masc_sipl
ⲑⲁⲏ	sost_asso_egiz_femm_sipl
ⲑⲁⲓⲃⲉⲥ	sost_asso_egiz_femm_sipl
ⲑⲁⲗⲁⲥⲥⲁ	sost_grec_femm_sipl
ⲑⲁⲣⲥⲟⲥ	sost_grec_masc_sipl
ⲑⲁⲯⲓⲥ	sost_grec_femm_sipl
ⲑⲉⲁⲧⲣⲟⲛ	sost_grec_masc_sipl
ⲑⲉⲓⲙⲁⲣⲙⲉⲛⲏ	sost_grec_femm_sipl
ⲑⲉⲗⲡⲓⲥ	sost_grec_femm_sipl
ⲑⲉⲟⲧⲟⲕⲟⲥ	sost_grec_femm_sipl
ⲑⲉⲟⲫⲓⲗⲉⲥⲧⲁⲧⲟⲥ	sost_grec_masc_sipl
ⲑⲉⲣⲙⲏⲛⲓⲁ	sost_grec_femm_sipl
ⲑⲉⲱⲣⲓⲁ	sost_grec_femm_sipl
ⲑⲏ	sost_asso_egiz_femm_sipl
ⲑⲏⲇⲟⲛⲏ	sost_grec_femm_sipl
ⲑⲏⲣⲓⲟⲛ	sost_grec_masc_sipl
ⲑⲏⲥⲁⲩⲣⲟⲥ	sost_grec_masc_sipl
ⲑⲏⲥⲓⲁⲥⲧⲏⲣⲓⲟⲛ	sost_grec_masc_sipl
ⲑⲓⲕⲱⲛ	sost_grec_femm_sipl
ⲑⲓⲙⲁⲣⲙⲉⲛⲏ	sost_grec_femm_sipl
ⲑⲗⲓⲯⲓⲥ	sost_grec_femm_sipl
ⲑⲙⲙⲉ	sost_asso_egiz_femm_sipl
ⲑⲟⲣⲁⲥⲓⲥ	sost_grec_femm_sipl
ⲑⲟⲧⲉ	sost_asso_egiz_femm_sipl
ⲑⲣⲉⲥⲕⲓⲁ	sost_grec_femm_sipl
ⲑⲣⲏⲥⲕⲓⲁ	sost_grec_femm_sipl
ⲑⲣⲟⲛⲟⲥ	sost_grec_masc_sipl
ⲑⲩⲗⲏ	sost_grec_femm_sipl
ⲑⲩⲙⲉⲗⲓⲕⲏ	sost_grec_masc_sipl
ⲑⲩⲙⲟⲥ	sost_grec_masc_sipl
ⲑⲩⲡⲟⲧⲁⲅⲏ	sost_grec_femm_siplsost_grec_femm_sipl
ⲑⲩⲣⲉⲟⲛ	sost_grec_masc_sipl
ⲑⲩⲣⲓⲟⲛ	sost_grec_masc_sipl
ⲑⲩⲥⲓⲁ	sost_grec_femm_sipl
ⲑⲩⲥⲓⲁⲥⲧⲏⲣⲓⲟⲛ	sost_grec_masc_sipl
ⲑⲩⲥⲓⲁⲥⲧⲩⲣⲓⲟⲛ	sost_grec_masc_sipl
ⲓⲉⲃⲉⲧ	sost_asso_egiz_masc_sipl
ⲓⲉⲣⲉⲩⲥ	sost_grec_masc_sipl
ⲓⲉⲣⲟ	sost_asso_egiz_masc_sipl
ⲓⲉⲣⲱⲟⲩ	sost_asso_egiz_plur
ⲓⲟⲧⲉ	sost_asso_egiz_plur
ⲓⲟⲩⲇⲁⲓ	sost_grec_masc_sipl
ⲓⲣⲏⲛⲏ	sost_grec_femm_sipl
ⲓⲣⲏⲛⲏⲕⲟⲛ	sost_grec_masc_sipl
ⲓⲣⲏⲛⲓⲕⲟⲛ	sost_grec_masc_sipl
ⲓⲥⲣⲁⲏⲗⲓⲧⲏⲥ	sost_grec_masc_sipl
ⲓⲥⲧⲟⲣⲓⲁ	sost_grec_femm_sipl
ⲓⲥⲧⲱⲣⲓⲁ	sost_grec_femm_sipl
ⲓⲱⲧ	sost_asso_egiz_masc_sing
ⲕⲁϣ	sost_asso_egiz_masc_sipl
ⲕⲁϩ	sost_asso_egiz_masc_sipl
ⲕⲁⲃⲁⲗⲗⲉⲩⲥ	sost_grec_masc_sipl
ⲕⲁⲍⲟⲫⲩⲗⲁⲅⲓⲟⲛ	sost_grec_masc_sipl
ⲕⲁⲍⲟⲫⲩⲗⲁⲕⲓⲟⲛ	sost_grec_masc_sipl
ⲕⲁⲑⲁⲓⲣⲉⲥⲓⲥ	sost_grec_femm_sipl
ⲕⲁⲑⲁⲓⲣⲏⲥⲓⲥ	sost_grec_femm_sipl
ⲕⲁⲑⲉⲇⲣⲁ	sost_grec_femm_sipl
ⲕⲁⲑⲉⲣⲉⲥⲓⲥ	sost_grec_femm_sipl
ⲕⲁⲑⲉⲣⲏⲥⲓⲥ	sost_grec_femm_sipl
ⲕⲁⲑⲟⲗⲓⲕϩ	sost_grec_femm_sipl
ⲕⲁⲑⲟⲗⲓⲕⲏ	sost_grec_femm_sipl
ⲕⲁⲓⲉ	sost_asso_egiz_femm_sipl
ⲕⲁⲓⲛⲏ	sost_grec_femm_sipl
ⲕⲁⲓⲣⲟⲥ	sost_grec_masc_sipl
ⲕⲁⲓⲥⲉ	sost_asso_egiz_masc_sipl
ⲕⲁⲓⲫⲁⲗⲁⲓⲟⲛ	sost_grec_masc_sipl
ⲕⲁⲕⲉ	sost_asso_egiz_masc_sipl
ⲕⲁⲕⲓⲁ	sost_grec_femm_sipl
ⲕⲁⲗⲁϩⲏ	sost_asso_egiz_femm_sipl
ⲕⲁⲗⲩⲃⲏ	sost_grec_femm_sipl
ⲕⲁⲙⲓⲥⲓⲟⲛ	sost_grec_masc_sipl
ⲕⲁⲛⲟⲛ	sost_grec_masc_sipl
ⲕⲁⲛⲱⲛ	sost_grec_masc_sipl
ⲕⲁⲡⲛⲟⲥ	sost_grec_masc_sipl
ⲕⲁⲡⲡⲁⲇⲟⲝ	sost_grec_masc_sipl
ⲕⲁⲣⲡⲟⲥ	sost_grec_masc_sipl
ⲕⲁⲥ	sost_asso_egiz_masc_sipl
ⲕⲁⲥⲓⲥ	sost_grec_femm_sipl
ⲕⲁⲥⲧⲣⲟⲛ	sost_grec_masc_sipl
ⲕⲁⲧⲁϩⲣⲁⲕⲧⲏⲥ	sost_grec_masc_sipl
ⲕⲁⲧⲁⲃⲟⲗⲏ	sost_grec_femm_sipl
ⲕⲁⲧⲁⲅⲓⲟⲛ	sost_grec_masc_sipl
ⲕⲁⲧⲁⲇⲓⲕⲟⲥ	sost_grec_masc_sipl
ⲕⲁⲧⲁⲕⲗⲉⲓⲥⲙⲟⲥ	sost_grec_masc_sipl
ⲕⲁⲧⲁⲕⲗⲩⲥⲙⲟⲥ	sost_grec_masc_sipl
ⲕⲁⲧⲁⲗⲁⲗⲓⲁ	sost_grec_femm_sipl
ⲕⲁⲧⲁⲡⲉⲧⲁⲥⲙⲁ	sost_grec_masc_sipl
ⲕⲁⲧⲁⲥⲧⲁⲥⲓⲥ	sost_grec_femm_sipl
ⲕⲁⲧⲁⲥⲧⲣⲟⲫⲏ	sost_grec_femm_sipl
ⲕⲁⲧⲁⲧⲓⲕⲏ	sost_grec_femm_sipl
ⲕⲁⲧⲏⲅⲟⲣⲓⲁ	sost_grec_femm_sipl
ⲕⲁⲧⲏⲭⲉⲥⲓⲥ	sost_grec_femm_sipl
ⲕⲁⲧⲟⲣⲑⲱⲙⲁ	sost_grec_masc_sipl
ⲕⲁⲧⲟⲣⲑⲱⲥⲓⲥ	sost_grec_femm_sipl
ⲕⲁⲩⲙⲁ	sost_grec_masc_sipl
ⲕⲁⲩⲥⲟⲛ	sost_grec_masc_sipl
ⲕⲁⲩⲥⲱⲛ	sost_grec_masc_sipl
ⲕⲃⲁ	sost_asso_egiz_masc_sipl
ⲕⲇⲏⲥⲓⲥ	sost_grec_femm_sipl
ⲕⲉ	sost_egiz_nomi
ⲕⲉⲃⲉⲣⲛⲏⲧⲏⲥ	sost_grec_masc_sipl
ⲕⲉⲇⲣⲟⲥ	sost_grec_masc_sipl
ⲕⲉⲉⲥ	sost_asso_egiz_masc_sipl
ⲕⲉⲓⲙⲏⲗⲓⲟⲛ	sost_grec_masc_sipl
ⲕⲉⲓⲙⲓⲗⲓⲟⲛ	sost_grec_masc_sipl
ⲕⲉⲗⲉⲃⲓⲛ	sost_asso_egiz_femm_sipl
ⲕⲉⲗⲉⲩⲥⲓⲥ	sost_grec_femm_sipl
ⲕⲉⲗⲗⲉ	sost_asso_egiz_femm_sipl
ⲕⲉⲙⲧⲟ	sost_asso_egiz_masc_sipl
ⲕⲉⲛⲇⲉⲛⲁⲣⲓⲟⲛ	sost_grec_masc_sipl
ⲕⲉⲛⲇⲓⲛⲁⲣⲓⲟⲛ	sost_grec_masc_sipl
ⲕⲉⲛⲉⲁ	sost_grec_femm_sipl
ⲕⲉⲛⲟⲇⲟⲝⲓⲁ	sost_grec_femm_sipl
ⲕⲉⲛⲧⲉⲛⲁⲣⲓⲟⲛ	sost_grec_masc_sipl
ⲕⲉⲛⲧⲓⲛⲁⲣⲓⲟⲛ	sost_grec_masc_sipl
ⲕⲉⲟⲙⲏⲧⲣⲓⲁ	sost_grec_femm_sipl
ⲕⲉⲟⲩⲁ	sost_asso_egiz_masc_sing
ⲕⲉⲣⲁⲙⲉⲩⲥ	sost_grec_masc_sipl
ⲕⲉⲣⲁⲥⲧⲏⲥ	sost_grec_masc_sipl
ⲕⲉⲣⲙⲉⲥ	sost_asso_egiz_masc_sipl
ⲕⲉⲥⲉⲉⲡⲉ	sost_asso_egiz_masc_sipl
ⲕⲉⲥⲏⲏⲡⲉ	sost_asso_egiz_mafe_sipl
ⲕⲉⲧ	sost_asso_egiz_masc_singsost_verb_nomi
ⲕⲉⲫⲁⲗⲁⲓⲟⲛ	sost_grec_masc_sipl
ⲕⲉⲫⲁⲗⲏ	sost_grec_femm_sipl
ⲕⲏⲛⲇⲉⲛⲁⲣⲓⲟⲛ	sost_grec_masc_sipl
ⲕⲏⲛⲇⲓⲛⲁⲣⲓⲟⲛ	sost_grec_masc_sipl
ⲕⲏⲛⲧⲉⲛⲁⲣⲓⲟⲛ	sost_grec_masc_sipl
ⲕⲏⲛⲧⲓⲛⲁⲣⲓⲟⲛ	sost_grec_masc_sipl
ⲕⲏⲡⲉ	sost_asso_egiz_femm_sipl
ⲕⲏⲡⲟⲥ	sost_grec_masc_sipl
ⲕⲏⲣⲓⲁⲕⲏ	sost_grec_femm_sipl
ⲕⲏⲣⲩⲅⲙⲁ	sost_grec_masc_sipl
ⲕⲏⲣⲩⲝ	sost_grec_masc_siplsost_grec_masc_sipl
ⲕⲓⲃⲟⲇⲟⲥ	sost_grec_femm_sipl
ⲕⲓⲃⲟⲧⲟⲥ	sost_grec_masc_siplsost_grec_femm_sipl
ⲕⲓⲃⲱⲧⲟⲥ	sost_grec_femm_sipl
ⲕⲓⲗⲓⲕⲓⲁ	sost_grec_femm_sipl
ⲕⲓⲗⲓⲕⲓⲱⲧⲏⲥ	sost_grec_masc_sipl
ⲕⲓⲛⲇⲩⲛⲟⲥ	sost_grec_masc_sipl
ⲕⲓⲛⲛⲁⲙⲱⲙⲟⲛ	sost_grec_masc_sipl
ⲕⲓⲣⲁ	sost_grec_femm_sipl
ⲕⲓⲣⲓⲁ	sost_grec_femm_sipl
ⲕⲗϫ	sost_asso_egiz_masc_sipl
ⲕⲗϫⲉ	sost_asso_egiz_masc_sipl
ⲕⲗⲁϥⲧ	sost_asso_egiz_femm_sipl
ⲕⲗⲁⲃⲧ	sost_asso_egiz_masc_sipl
ⲕⲗⲁⲇⲟⲥ	sost_grec_masc_sipl
ⲕⲗⲏⲣⲓⲕⲟⲥ	sost_grec_masc_sipl
ⲕⲗⲏⲣⲟⲛⲟⲙⲓⲁ	sost_grec_femm_sipl
ⲕⲗⲏⲣⲟⲛⲟⲙⲟⲥ	sost_grec_masc_sipl
ⲕⲗⲏⲣⲟⲥ	sost_grec_masc_sipl
ⲕⲗⲗⲉ	sost_asso_egiz_femm_sipl
ⲕⲗⲟⲙ	sost_asso_egiz_masc_sipl
ⲕⲗⲟⲟⲗⲉ	sost_asso_egiz_femm_sipl
ⲕⲗⲩⲣⲓⲕⲟⲥ	sost_grec_masc_sipl
ⲕⲗⲩⲣⲟⲛⲟⲙⲓⲁ	sost_grec_femm_sipl
ⲕⲙⲟⲙ	sost_asso_egiz_masc_sipl
ⲕⲙⲧⲟ	sost_asso_egiz_masc_sipl
ⲕⲛⲧⲉ	sost_asso_egiz_masc_sipl
ⲕⲟⲉⲓϩ	sost_asso_egiz_masc_sipl
ⲕⲟⲓⲗⲓⲁ	sost_grec_femm_sipl
ⲕⲟⲓⲙⲏⲧⲏⲣⲓⲟⲛ	sost_grec_masc_sipl
ⲕⲟⲓⲛⲟⲛⲓⲁ	sost_grec_femm_sipl
ⲕⲟⲓⲛⲱⲃⲓⲟⲛ	sost_grec_masc_sipl
ⲕⲟⲓⲛⲱⲛⲓⲁ	sost_grec_femm_sipl
ⲕⲟⲓⲛⲱⲛⲟⲥ	sost_grec_masc_sipl
ⲕⲟⲓⲧⲱⲛ	sost_grec_masc_sipl
ⲕⲟⲗⲁⲥⲓⲥ	sost_grec_femm_sipl
ⲕⲟⲗⲗⲩⲕⲓⲟⲛ
ⲕⲟⲗⲩⲙⲃⲏⲑⲣⲁ	sost_grec_femm_sipl
ⲕⲟⲙⲉⲥ	sost_grec_masc_sipl
ⲕⲟⲙⲏⲥ	sost_grec_masc_sipl
ⲕⲟⲙⲓⲥ	sost_grec_masc_sipl
ⲕⲟⲟϩ	sost_asso_egiz_masc_sipl
ⲕⲟⲟⲩ	sost_asso_egiz_masc_sipl
ⲕⲟⲟⲩⲉ	sost_asso_egiz_plur
ⲕⲟⲡⲣⲓⲁ	sost_grec_femm_sipl
ⲕⲟⲣⲃⲁⲛⲟⲥ	sost_grec_masc_sipl
ⲕⲟⲥⲙⲏⲥⲓⲥ	sost_grec_femm_sipl
ⲕⲟⲥⲙⲟⲥ	sost_grec_masc_sipl
ⲕⲟⲧ	sost_asso_egiz_masc_siplsost_verb_pron
ⲕⲟⲧⲕ	sost_asso_egiz_masc_sipl
ⲕⲟⲩⲉⲓ
ⲕⲟⲩⲓ	sost_asso_egiz_mafe_sipl
ⲕⲟⲩⲛⲥ	sost_asso_egiz_masc_sipl
ⲕⲟⲩⲫⲟⲛ	sost_grec_masc_sipl
ⲕⲣⲁⲧⲟⲥ	sost_grec_masc_siplsost_grec_masc_sipl
ⲕⲣⲓⲕⲟⲥ	sost_grec_masc_sipl
ⲕⲣⲓⲙⲁ	sost_grec_masc_sipl
ⲕⲣⲓⲛⲟⲛ	sost_grec_masc_sipl
ⲕⲣⲓⲥⲓⲥ	sost_grec_femm_sipl
ⲕⲣⲓⲧⲏⲥ	sost_grec_masc_sipl
ⲕⲣⲙⲉⲥ	sost_asso_egiz_masc_sipl
ⲕⲣⲟ	sost_asso_egiz_masc_sipl
ⲕⲣⲟϥ	sost_asso_egiz_masc_sipl
ⲕⲣⲱⲙ	sost_asso_egiz_masc_sipl
ⲕⲧⲏⲙⲁ	sost_grec_masc_sipl
ⲕⲧⲏⲥⲓⲥ	sost_grec_femm_sipl
ⲕⲧⲓⲥⲓⲥ	sost_grec_femm_sipl
ⲕⲧⲓⲥⲙⲁ	sost_grec_masc_sipl
ⲕⲩⲛⲇⲉⲛⲁⲣⲓⲟⲛ	sost_grec_masc_sipl
ⲕⲩⲛⲇⲓⲛⲁⲣⲓⲟⲛ	sost_grec_masc_sipl
ⲕⲩⲛⲇⲩⲛⲟⲥ	sost_grec_masc_sipl
ⲕⲩⲛⲧⲉⲛⲁⲣⲓⲟⲛ	sost_grec_masc_sipl
ⲕⲩⲛⲧⲓⲛⲁⲣⲓⲟⲛ	sost_grec_masc_sipl
ⲕⲩⲡⲟⲥ	sost_grec_masc_sipl
ⲕⲩⲣⲁ	sost_grec_femm_sipl
ⲕⲩⲣⲓⲁ	sost_grec_femm_sipl
ⲕⲩⲣⲓⲁⲕⲏ	sost_grec_femm_sipl
ⲕⲩⲣⲩⲝ	sost_grec_masc_sipl
ⲕⲱϩⲧ	sost_asso_egiz_masc_sipl
ⲕⲱⲗⲁⲥⲓⲥ	sost_grec_femm_sipl
ⲕⲱⲙⲁⲣⲓⲟⲛ	sost_grec_masc_sipl
ⲕⲱⲙⲉⲥ	sost_grec_masc_sipl
ⲕⲱⲙⲏⲧⲁⲧⲟⲛ	sost_grec_masc_sipl
ⲕⲱⲙⲓⲥ	sost_grec_masc_sipl
ⲕⲱⲙⲓⲧⲁⲧⲟⲛ	sost_grec_masc_sipl
ⲕⲱⲙⲓⲧⲁⲧⲱⲛ	sost_grec_masc_sipl
ⲕⲱⲛⲓⲁ	sost_grec_femm_sipl
ⲗⲁⲁⲩ	sost_asso_egiz_mafe_sipl
ⲗⲁⲓⲕⲟⲥ	sost_grec_masc_sipl
ⲗⲁⲕⲉⲙ	sost_asso_egiz_femm_sipl
ⲗⲁⲕⲙ	sost_asso_egiz_femm_sipl
ⲗⲁⲕⲱⲛ	sost_grec_masc_sipl
ⲗⲁⲙϫⲁⲧⲡ	sost_asso_egiz_masc_sipl
ⲗⲁⲙⲡⲁⲥ	sost_grec_masc_sipl
ⲗⲁⲙⲡⲣⲟⲛ	sost_grec_masc_sipl
ⲗⲁⲟⲥ	sost_grec_masc_sipl
ⲗⲁⲥ	sost_asso_egiz_masc_sipl
ⲗⲁⲧⲟⲙⲟⲥ	sost_grec_masc_sipl
ⲗⲉⲃⲓⲧⲱⲛ	sost_grec_masc_sipl
ⲗⲉⲓⲧⲟⲩⲣⲅⲓⲁ	sost_grec_femm_sipl
ⲗⲉⲓⲧⲟⲩⲣⲅⲟⲥ	sost_grec_masc_sipl
ⲗⲉⲝⲓⲥ	sost_grec_femm_sipl
ⲗⲏⲙⲏⲛ	sost_grec_masc_sipl
ⲗⲏⲥⲧⲏⲥ	sost_grec_masc_sipl
ⲗⲓⲃⲓⲧⲟⲛ	sost_grec_masc_sipl
ⲗⲓⲃⲓⲧⲟⲩ	sost_grec_masc_sipl
ⲗⲓⲃⲓⲧⲱⲛ	sost_grec_masc_sipl
ⲗⲓⲅⲓⲕⲟⲛ	sost_grec_masc_sipl
ⲗⲓⲕⲓⲕⲟⲛ	sost_grec_masc_sipl
ⲗⲓⲙⲏⲛ	sost_grec_masc_sipl
ⲗⲓⲙⲛⲏ	sost_grec_masc_sipl
ⲗⲓⲥⲧⲏⲥ	sost_grec_masc_sipl
ⲗⲓⲧⲟⲩⲣⲅⲓⲁ	sost_grec_femm_sipl
ⲗⲓⲧⲟⲩⲣⲅⲟⲥ	sost_grec_masc_sipl
ⲗⲕϣⲁ	sost_asso_egiz_masc_sipl
ⲗⲕⲥϣⲁ	sost_asso_egiz_masc_sipl
ⲗⲗⲏⲃ	sost_asso_egiz_masc_sipl
ⲗⲟⲅⲓⲕⲟⲥ	sost_grec_masc_sipl
ⲗⲟⲅⲓⲟⲥ	sost_grec_masc_sipl
ⲗⲟⲅⲓⲥⲙⲟⲥ	sost_grec_masc_sipl
ⲗⲟⲅⲟⲥ	sost_grec_masc_sipl
ⲗⲟⲅⲭⲏ	sost_grec_femm_sipl
ⲗⲟⲉⲓϩⲉ	sost_asso_egiz_mafe_sipl
ⲗⲟⲉⲓϭⲉ	sost_asso_egiz_femm_sipl
ⲗⲟⲓϩⲉ	sost_asso_egiz_mafe_sipl
ⲗⲟⲓϭⲉ	sost_asso_egiz_femm_sipl
ⲗⲟⲓⲙⲟⲥ	sost_grec_masc_sipl
ⲗⲩⲃⲓⲧⲟⲛ	sost_grec_masc_sipl
ⲗⲩⲃⲓⲧⲱⲛ	sost_grec_masc_sipl
ⲗⲩⲅⲓⲕⲟⲛ	sost_grec_masc_sipl
ⲗⲩⲕⲓⲕⲟⲛ	sost_grec_masc_sipl
ⲗⲩⲥⲧⲏⲥ
ⲗⲩⲭⲛⲓⲁ	sost_grec_femm_sipl
ⲗⲱⲕϣ	sost_asso_egiz_masc_sipl
ⲙϩⲁⲁⲩ	sost_asso_egiz_masc_sipl
ⲙϩⲓⲧ	sost_asso_egiz_masc_sipl
ⲙⲁ	sost_asso_egiz_masc_sipl
ⲙⲁϩⲉ	sost_asso_egiz_masc_sipl
ⲙⲁϩⲧ	sost_asso_egiz_masc_sipl
ⲙⲁⲁϫⲉ	sost_asso_egiz_masc_sipl
ⲙⲁⲁⲃ	nume
ⲙⲁⲁⲃⲉⲙⲛϣⲟⲙⲧⲉ	nume
ⲙⲁⲁⲃⲧⲏ	nume
ⲙⲁⲁⲩ	sost_asso_egiz_femm_sipl
ⲙⲁⲃⲧⲏ	nume
ⲙⲁⲅⲉⲓⲁ	sost_grec_femm_sipl
ⲙⲁⲅⲓⲁ	sost_grec_femm_sipl
ⲙⲁⲅⲓⲥⲧⲣⲓⲁⲛⲟⲥ	sost_grec_masc_sipl
ⲙⲁⲅⲟⲥ	sost_grec_masc_sipl
ⲙⲁⲉⲓⲛ	sost_asso_egiz_masc_sipl
ⲙⲁⲉⲧϣϣⲉ	sost_asso_egiz_masc_sipl
ⲙⲁⲉⲧⲉϣϣⲉ	sost_asso_egiz_masc_sipl
ⲙⲁⲑⲏⲧⲏⲥ	sost_grec_masc_sipl
ⲙⲁⲓϣⲙⲙⲟ	sost_asso_egiz_mafe_sipl
ⲙⲁⲓϩⲏⲕⲉ	sost_asso_egiz_mafe_sipl
ⲙⲁⲓϩⲏⲩ	sost_asso_egiz_mafe_sipl
ⲙⲁⲓϫⲁⲓⲉ	sost_asso_egiz_mafe_sipl
ⲙⲁⲓϯⲧⲱⲛ	sost_asso_egiz_masc_sipl
ⲙⲁⲓⲛⲟⲩⲧⲉ	sost_asso_egiz_mafe_sipl
ⲙⲁⲓⲡⲉⲭⲣⲓⲥⲧⲟⲥ	sost_asso_egiz_masc_sipl
ⲙⲁⲓⲣⲱⲙⲉ	sost_asso_egiz_mafe_sipl
ⲙⲁⲓⲥⲃⲱ	sost_asso_egiz_mafe_sipl
ⲙⲁⲓⲥⲱⲧⲙ	sost_asso_egiz_mafe_sipl
ⲙⲁⲓⲧⲟⲛϩⲟⲩⲟ	sost_asso_egiz_masc_sipl
ⲙⲁⲕϩ	sost_asso_egiz_masc_sipl
ⲙⲁⲕⲁⲣⲓⲟⲥ	sost_grec_masc_sipl
ⲙⲁⲕⲁⲣⲓⲥⲙⲟⲥ	sost_grec_masc_sipl
ⲙⲁⲙⲙⲟⲟⲛⲉ	sost_asso_egiz_masc_sipl
ⲙⲁⲙⲡⲱⲧ	sost_asso_egiz_masc_sipl
ⲙⲁⲛϣⲁ	sost_asso_egiz_masc_sipl
ⲙⲁⲛϣⲉⲗⲉⲉⲧ	sost_asso_egiz_masc_sipl
ⲙⲁⲛϣⲓⲛⲉ	sost_asso_egiz_masc_sipl
ⲙⲁⲛϣⲱⲡⲉ	sost_asso_egiz_masc_sipl
ⲙⲁⲛϩⲁⲣⲉϩ	sost_asso_egiz_masc_sipl
ⲙⲁⲛϩⲱⲧⲡ	sost_asso_egiz_masc_sipl
ⲙⲁⲛϫⲁⲓⲉ	sost_asso_egiz_masc_sipl
ⲙⲁⲛⲉⲗⲟⲟⲗⲉ	sost_asso_egiz_masc_sipl
ⲙⲁⲛⲓⲁ	sost_grec_femm_sipl
ⲙⲁⲛⲓⲁⲕⲏⲥ	sost_grec_masc_sipl
ⲙⲁⲛⲙⲧⲟⲛ	sost_asso_egiz_masc_sipl
ⲙⲁⲛⲛⲉⲓⲇⲱⲗⲟⲛ	sost_asso_egiz_masc_sipl
ⲙⲁⲛⲟⲩⲱϩ	sost_asso_egiz_masc_sipl
ⲙⲁⲛⲟⲩⲱⲙ	sost_asso_egiz_masc_sipl
ⲙⲁⲛⲱⲧⲡⲉϩⲟⲩⲛ	sost_asso_egiz_masc_sipl
ⲙⲁⲝⲓⲙⲓⲛⲟⲥ	sost_grec_masc_sipl
ⲙⲁⲡⲡⲁ	sost_grec_masc_sipl
ⲙⲁⲣⲅⲁⲣⲓⲧⲏⲥ	sost_grec_femm_sipl
ⲙⲁⲣⲧⲏⲣⲓⲟⲛ	sost_grec_masc_sipl
ⲙⲁⲣⲧⲩⲣⲓⲁ	sost_grec_femm_sipl
ⲙⲁⲣⲧⲩⲣⲓⲟⲛ	sost_grec_masc_sipl
ⲙⲁⲣⲧⲩⲣⲟⲥ	sost_grec_masc_sipl
ⲙⲁⲥⲧϩⲏⲧ	sost_asso_egiz_masc_sipl
ⲙⲁⲥⲧⲉ	sost_egiz_nomi
ⲙⲁⲥⲧⲉⲛⲟⲩⲧⲉ	sost_asso_egiz_mafe_sipl
ⲙⲁⲥⲧⲓⲅⲝ	sost_grec_masc_sipl
ⲙⲁⲥⲧⲛⲟⲩⲧⲉ	sost_asso_egiz_masc_sipl
ⲙⲁⲥⲧⲫⲑⲟⲛⲉⲓ	sost_asso_egiz_mafe_sipl
ⲙⲁⲧⲟⲓ	sost_asso_egiz_masc_sipl
ⲙⲁⲧⲟⲩ	sost_asso_egiz_masc_sipl
ⲙⲁⲧⲣⲱⲛⲁ	sost_grec_femm_sipl
ⲙⲉ	triptripsost_asso_egiz_femm_siplsost_verb_asso
ⲙⲉϩ	adnusost_verb_nomiqual
ⲙⲉϩⲣⲟ	sost_asso_egiz_masc_sipl
ⲙⲉⲅⲉⲑⲟⲥ	sost_grec_masc_sipl
ⲙⲉⲉⲣⲉ	sost_asso_egiz_mafe_sipl
ⲙⲉⲉⲩⲉ	sost_verb_asso
ⲙⲉⲗⲉⲧⲏ	sost_grec_femm_sipl
ⲙⲉⲗⲉⲧⲓⲁⲛⲟⲥ	sost_grec_masc_sipl
ⲙⲉⲗⲓⲧⲓⲁⲛⲟⲥ	sost_grec_masc_sipl
ⲙⲉⲗⲟⲥ	sost_grec_masc_sipl
ⲙⲉⲗⲱⲧ	sost_asso_egiz_femm_sipl
ⲙⲉⲣϩ	sost_asso_egiz_masc_sipl
ⲙⲉⲣⲁⲧⲉ	sost_asso_egiz_plur
ⲙⲉⲣⲉϩ	sost_asso_egiz_masc_sipl
ⲙⲉⲣⲓⲥ	sost_grec_femm_sipl
ⲙⲉⲣⲓⲧ	sost_asso_egiz_masc_singsost_verb_pron
ⲙⲉⲣⲟⲥ	sost_grec_masc_sipl
ⲙⲉⲥⲓⲧⲏⲥ	sost_grec_masc_sipl
ⲙⲉⲧⲁⲛⲟⲓⲁ	sost_grec_femm_sipl
ⲙⲏϣⲉ	sost_asso_egiz_masc_sipl
ⲙⲏⲏϣⲉ	sost_asso_egiz_masc_sipl
ⲙⲏⲏⲛⲉ	sost_asso_egiz_masc_sipl
ⲙⲏⲗⲓⲧⲓⲁⲛⲟⲥ	sost_grec_masc_sipl
ⲙⲏⲥⲉ	sost_asso_egiz_femm_sipl
ⲙⲏⲥⲧⲏⲣⲓⲟⲛ	sost_grec_masc_sipl
ⲙⲏⲧ	sost_asso_egiz_masc_sipl
ⲙⲏⲧϣⲙⲏⲛⲉ	nume
ⲙⲏⲧⲉ	sost_asso_egiz_femm_sipl
ⲙⲏⲧⲛϣⲏ	nume
ⲙⲏⲧⲣⲁ	sost_grec_femm_sipl
ⲙⲏⲧⲣⲟⲡⲟⲗⲓⲥ	sost_grec_femm_sipl
ⲙⲓⲙⲁⲣⲓⲟⲛ	sost_grec_masc_sipl
ⲙⲓⲙⲏⲥⲓⲥ	sost_grec_femm_sipl
ⲙⲓⲛⲉ	sost_asso_egiz_femm_sipl
ⲙⲓⲧⲣⲁ	sost_grec_femm_sipl
ⲙⲕⲁϩ	sost_verb_asso
ⲙⲗⲁϩ	sost_asso_egiz_masc_sipl
ⲙⲛⲟⲩⲧ	sost_asso_egiz_masc_sipl
ⲙⲛⲧϣⲁϥⲧⲉ	sost_asso_egiz_femm_sipl
ⲙⲛⲧϣⲁⲛϩⲧⲏϥ	sost_asso_egiz_femm_sipl
ⲙⲛⲧϣⲁⲛⲁϩⲧⲏϥ	sost_asso_egiz_femm_sipl
ⲙⲛⲧϣⲃⲏⲣ	sost_asso_egiz_femm_sipl
ⲙⲛⲧϣⲏⲣⲉ	sost_asso_egiz_femm_sipl
ⲙⲛⲧϣⲏⲣⲉϣⲏⲙ	sost_asso_egiz_femm_sipl
ⲙⲛⲧϣⲙⲏⲛ	nume
ⲙⲛⲧϣⲙⲙⲟ	sost_asso_egiz_femm_sipl
ⲙⲛⲧϣⲟⲙⲧⲉ	nume
ⲙⲛⲧϣⲟⲩϣⲟ	sost_asso_egiz_femm_sipl
ⲙⲛⲧϣⲱⲥ	sost_asso_egiz_femm_sipl
ⲙⲛⲧϥⲁⲓⲣⲟⲟⲩϣ	sost_asso_egiz_femm_sipl
ⲙⲛⲧϩⲁⲕ	sost_asso_egiz_femm_sipl
ⲙⲛⲧϩⲁⲕⲟ	sost_asso_egiz_femm_sipl
ⲙⲛⲧϩⲁⲡⲗⲟⲩⲥ	sost_asso_egiz_femm_sipl
ⲙⲛⲧϩⲁⲣϣϩⲏⲧ	sost_asso_egiz_femm_sipl
ⲙⲛⲧϩⲉⲃⲣⲁⲓⲟⲥ	sost_asso_egiz_femm_sipl
ⲙⲛⲧϩⲉⲗⲗⲏⲛ	sost_asso_egiz_femm_sipl
ⲙⲛⲧϩⲏⲕⲉ	sost_asso_egiz_femm_sipl
ⲙⲛⲧϩⲗⲗⲏⲛ	sost_asso_egiz_femm_sipl
ⲙⲛⲧϩⲗⲗⲟ	sost_asso_egiz_femm_sipl
ⲙⲛⲧϩⲗⲗⲱ
ⲙⲛⲧϩⲙϩⲁⲗ	sost_asso_egiz_femm_sipl
ⲙⲛⲧϩⲣⲟⲩⲱ	sost_asso_egiz_femm_sipl
ⲙⲛⲧϫⲁϫⲉ	sost_asso_egiz_femm_sipl
ⲙⲛⲧϫⲁⲣϩⲏⲧ	sost_asso_egiz_femm_sipl
ⲙⲛⲧϫⲁⲥⲓϩⲏⲧ	sost_asso_egiz_femm_sipl
ⲙⲛⲧϫⲓⲟⲩⲁ	sost_asso_egiz_femm_sipl
ⲙⲛⲧϫⲟⲉⲓⲥ	sost_asso_egiz_femm_sipl
ⲙⲛⲧϫⲟⲓⲥ	sost_asso_egiz_femm_sipl
ⲙⲛⲧϫⲱⲱⲣⲉ	sost_asso_egiz_femm_sipl
ⲙⲛⲧϭⲱⲃ	sost_asso_egiz_femm_sipl
ⲙⲛⲧⲁⲅⲁⲑⲟⲥ	sost_asso_egiz_femm_sipl
ⲙⲛⲧⲁⲑⲏⲧ	sost_asso_egiz_femm_sipl
ⲙⲛⲧⲁⲕⲁⲑⲁⲣⲧⲟⲥ	sost_asso_egiz_femm_sipl
ⲙⲛⲧⲁⲛⲁⲭⲱⲣⲓⲧⲏⲥ	sost_asso_egiz_femm_sipl
ⲙⲛⲧⲁⲡⲁⲛⲑⲣⲱⲡⲟⲥ	sost_asso_egiz_mafe_sipl
ⲙⲛⲧⲁⲡⲓⲥⲧⲟⲥ	sost_asso_egiz_femm_sipl
ⲙⲛⲧⲁⲣⲭⲏⲉⲡⲓⲥⲕⲟⲡⲟⲥ	sost_asso_egiz_femm_sipl
ⲙⲛⲧⲁⲣⲭⲓⲉⲡⲓⲥⲕⲟⲡⲟⲥ	sost_asso_egiz_femm_sipl
ⲙⲛⲧⲁⲣⲭⲓⲉⲣⲉⲩⲥ	sost_asso_egiz_femm_sipl
ⲙⲛⲧⲁⲥⲉⲃⲏⲥ	sost_asso_egiz_femm_sipl
ⲙⲛⲧⲁⲥⲕⲏⲧⲏⲥ	sost_asso_egiz_femm_sipl
ⲙⲛⲧⲁⲥⲥⲉ	nume
ⲙⲛⲧⲁⲧϣⲓⲡⲉ	sost_asso_egiz_femm_sipl
ⲙⲛⲧⲁⲧϣⲟϫⲛⲉ	sost_asso_egiz_femm_sipl
ⲙⲛⲧⲁⲧϩⲟⲧⲉ	sost_asso_egiz_femm_sipl
ⲙⲛⲧⲁⲧϭⲟⲙ	sost_asso_egiz_femm_sipl
ⲙⲛⲧⲁⲧϯⲥⲟ	sost_asso_egiz_femm_sipl
ⲙⲛⲧⲁⲧⲃⲁⲗ	sost_asso_egiz_femm_sipl
ⲙⲛⲧⲁⲧⲃⲟⲧⲉ	sost_asso_egiz_femm_sipl
ⲙⲛⲧⲁⲧⲙⲟⲩ	sost_asso_egiz_femm_sipl
ⲙⲛⲧⲁⲧⲛⲁ	sost_asso_egiz_femm_sipl
ⲙⲛⲧⲁⲧⲛⲁϩⲧⲉ	sost_asso_egiz_mafe_sipl
ⲙⲛⲧⲁⲧⲛⲟⲩⲧⲉ	sost_asso_egiz_femm_sipl
ⲙⲛⲧⲁⲧⲣⲟⲟⲩϣ	sost_asso_egiz_femm_sipl
ⲙⲛⲧⲁⲧⲥⲃⲱ	sost_asso_egiz_femm_sipl
ⲙⲛⲧⲁⲧⲥⲉⲓ	sost_asso_egiz_femm_sipl
ⲙⲛⲧⲁⲧⲥⲟⲟⲩⲛ	sost_asso_egiz_femm_sipl
ⲙⲛⲧⲁⲧⲥⲱⲧⲙ	sost_asso_egiz_femm_sipl
ⲙⲛⲧⲁⲧⲧⲱϣ	sost_asso_egiz_femm_sipl
ⲙⲛⲧⲃⲁⲗϩⲏⲧ	sost_asso_egiz_femm_sipl
ⲙⲛⲧⲇⲓⲕⲁⲓⲟⲥ	sost_asso_egiz_femm_sipl
ⲙⲛⲧⲉϣⲱⲱⲧ	sost_asso_egiz_femm_sipl
ⲙⲛⲧⲉⲃⲓⲏⲛ	sost_asso_egiz_femm_sipl
ⲙⲛⲧⲉⲓⲱⲧ	sost_asso_egiz_femm_sipl
ⲙⲛⲧⲉⲡⲓⲥⲕⲟⲡⲟⲥ	sost_asso_egiz_femm_sipl
ⲙⲛⲧⲉⲣⲟ	sost_asso_egiz_femm_sipl
ⲙⲛⲧⲉⲣⲱⲟⲩ	sost_asso_egiz_plur
ⲙⲛⲧⲉⲩⲥⲉⲃⲏⲥ	sost_asso_egiz_femm_sipl
ⲙⲛⲧⲉⲩⲧⲉⲗⲏⲥ	sost_asso_egiz_femm_sipl
ⲙⲛⲧⲏ	nume
ⲙⲛⲧⲏⲡⲉ	sost_asso_egiz_femm_sipl
ⲙⲛⲧⲓⲱⲧ	sost_asso_egiz_femm_sipl
ⲙⲛⲧⲕⲁⲑⲁⲣⲟⲥ	sost_asso_egiz_femm_sipl
ⲙⲛⲧⲕⲁⲧⲁⲣⲱⲙⲉ	sost_asso_egiz_femm_sipl
ⲙⲛⲧⲕⲟⲩⲉⲓ	sost_asso_egiz_femm_sipl
ⲙⲛⲧⲕⲟⲩⲓ	sost_asso_egiz_femm_sipl
ⲙⲛⲧⲙⲁⲓϣⲏⲣⲉ	sost_asso_egiz_femm_sipl
ⲙⲛⲧⲙⲁⲓⲕⲟⲥⲙⲉⲓ	sost_asso_egiz_femm_sipl
ⲙⲛⲧⲙⲁⲓⲛⲟⲩⲧⲉ	sost_asso_egiz_femm_sipl
ⲙⲛⲧⲙⲁⲓⲣⲱⲙⲉ	sost_asso_egiz_femm_sipl
ⲙⲛⲧⲙⲁⲓⲥⲟⲛ	sost_asso_egiz_femm_sipl
ⲙⲛⲧⲙⲁⲓⲭⲣⲏⲙⲁ	sost_asso_egiz_femm_sipl
ⲙⲛⲧⲙⲁⲕⲁⲣⲓⲟⲥ	sost_asso_egiz_femm_sipl
ⲙⲛⲧⲙⲁⲣⲧⲩⲣⲟⲥ	sost_asso_egiz_femm_sipl
ⲙⲛⲧⲙⲁⲧⲟⲓ	sost_asso_egiz_femm_sipl
ⲙⲛⲧⲙⲉ	sost_asso_egiz_femm_siplsost_asso_egiz_femm_sipl
ⲙⲛⲧⲙⲛⲧⲣⲉ	sost_asso_egiz_femm_sipl
ⲙⲛⲧⲙⲟⲛⲁⲭⲟⲥ	sost_asso_egiz_femm_sipl
ⲙⲛⲧⲙⲟⲛⲟⲭⲟⲥ	sost_asso_egiz_femm_sipl
ⲙⲛⲧⲛⲁ	sost_asso_egiz_femm_sipl
ⲙⲛⲧⲛⲁϣⲧⲙⲁⲕϩ	sost_asso_egiz_femm_sipl
ⲙⲛⲧⲛⲁⲏⲧ	sost_asso_egiz_femm_sipl
ⲙⲛⲧⲛⲟϭ	sost_asso_egiz_femm_sipl
ⲙⲛⲧⲛⲟⲉⲓⲕ	sost_asso_egiz_femm_sipl
ⲙⲛⲧⲛⲟⲩⲧⲉ	sost_asso_egiz_femm_sipl
ⲙⲛⲧⲟⲩⲉ	sost_asso_egiz_femm_sipl
ⲙⲛⲧⲟⲩⲏⲏⲃ	sost_asso_egiz_femm_sipl
ⲙⲛⲧⲡⲁⲣⲁⲃⲁⲧⲏⲥ	sost_asso_egiz_femm_sipl
ⲙⲛⲧⲡⲁⲣⲑⲉⲛⲟⲥ	sost_asso_egiz_femm_sipl
ⲙⲛⲧⲡⲉⲣⲓⲉⲣⲅⲟⲥ	sost_asso_egiz_femm_sipl
ⲙⲛⲧⲡⲉⲧϣⲟⲩⲉⲓⲧ	sost_asso_egiz_femm_sipl
ⲙⲛⲧⲡⲉⲧⲟⲩⲁⲁⲃ	sost_asso_egiz_femm_sipl
ⲙⲛⲧⲡⲟⲛⲏⲣⲟⲥ	sost_asso_egiz_femm_sipl
ⲙⲛⲧⲣⲉ	sost_asso_egiz_femm_sipl
ⲙⲛⲧⲣⲉϥϣⲉⲙϣⲉⲛⲟⲩⲧⲉ	sost_asso_egiz_femm_sipl
ⲙⲛⲧⲣⲉϥϣⲙϣⲉⲉⲓⲇⲱⲗⲟⲛ	sost_asso_egiz_femm_sipl
ⲙⲛⲧⲣⲉϥϣⲙϣⲉⲛⲟⲩⲧⲉ	sost_asso_egiz_femm_sipl
ⲙⲛⲧⲣⲉϥϣⲟⲟⲣ	sost_asso_egiz_femm_sipl
ⲙⲛⲧⲣⲉϥϩⲉⲧⲃⲣⲱⲙⲉ	sost_asso_egiz_femm_sipl
ⲙⲛⲧⲣⲉϥϫⲓϩⲟ	sost_asso_egiz_femm_sipl
ⲙⲛⲧⲣⲉϥϫⲓⲙⲏⲥⲉ	sost_asso_egiz_femm_sipl
ⲙⲛⲧⲣⲉϥϫⲓⲛϭⲟⲛⲥ	sost_asso_egiz_femm_sipl
ⲙⲛⲧⲣⲉϥϫⲓⲟⲩⲁ	sost_asso_egiz_femm_sipl
ⲙⲛⲧⲣⲉϥϫⲛⲁⲁⲩ	sost_asso_egiz_femm_sipl
ⲙⲛⲧⲣⲉϥϭⲛⲁⲣⲓⲕⲉ	sost_asso_egiz_femm_sipl
ⲙⲛⲧⲣⲉϥϯϭⲱⲛⲧ
ⲙⲛⲧⲣⲉϥϯⲧⲱⲛ	sost_asso_egiz_femm_sipl
ⲙⲛⲧⲣⲉϥⲇⲓⲁⲕⲟⲛⲉⲓ	sost_asso_egiz_mafe_sipl
ⲙⲛⲧⲣⲉϥⲣϩⲁⲗ	sost_asso_egiz_femm_sipl
ⲙⲛⲧⲣⲉϥⲧⲁⲕⲉϩⲏⲧ	sost_asso_egiz_femm_sipl
ⲙⲛⲧⲣⲉⲙⲙⲁⲟ	sost_asso_egiz_femm_sipl
ⲙⲛⲧⲣⲉⲙⲛϩⲏⲧ	sost_asso_egiz_femm_sipl
ⲙⲛⲧⲣⲉⲛⲛⲟⲩϫ	sost_asso_egiz_femm_sipl
ⲙⲛⲧⲣⲙϩⲉ	sost_asso_egiz_femm_sipl
ⲙⲛⲧⲣⲙⲙⲁⲟ	sost_asso_egiz_femm_sipl
ⲙⲛⲧⲣⲙⲛϩⲏⲧ	sost_asso_egiz_femm_sipl
ⲙⲛⲧⲣⲙⲣⲁϣ	sost_asso_egiz_femm_sipl
ⲙⲛⲧⲣⲣⲟ	sost_asso_egiz_femm_sipl
ⲙⲛⲧⲣⲣⲱⲟⲩ	sost_asso_egiz_plur
ⲙⲛⲧⲣⲱⲙⲉ	sost_asso_egiz_femm_sipl
ⲙⲛⲧⲥⲁⲃⲉ	sost_asso_egiz_femm_sipl
ⲙⲛⲧⲥⲁⲓⲉ	sost_asso_egiz_femm_sipl
ⲙⲛⲧⲥⲉⲙⲛⲟⲥ	sost_asso_egiz_femm_sipl
ⲙⲛⲧⲥⲛⲟⲟⲩⲥ	nume
ⲙⲛⲧⲥⲟϭ	sost_asso_egiz_femm_sipl
ⲙⲛⲧⲥⲡⲁⲑⲁⲣⲓⲟⲥ	sost_asso_egiz_femm_sipl
ⲙⲛⲧⲥⲧⲙⲏⲧ	sost_asso_egiz_femm_sipl
ⲙⲛⲧⲥⲧⲣⲁⲧⲏⲗⲁⲧⲏⲥ	sost_asso_egiz_femm_sipl
ⲙⲛⲧⲧⲉⲗⲉⲓⲟⲥ	sost_asso_egiz_femm_sipl
ⲙⲛⲧⲧⲉⲗⲓⲟⲥ	sost_asso_egiz_femm_sipl
ⲙⲛⲧⲧⲟⲗⲙⲏⲣⲟⲥ	sost_asso_egiz_femm_sipl
ⲙⲛⲧⲧⲩⲣⲁⲛⲛⲟⲥ	sost_asso_egiz_femm_sipl
ⲙⲛⲧⲫⲁⲩⲗⲟⲥ	sost_asso_egiz_femm_sipl
ⲙⲛⲧⲭⲣⲏⲥⲧⲟⲥ	sost_asso_egiz_femm_sipl
ⲙⲟϫϩ	sost_asso_egiz_masc_sipl
ⲙⲟⲉⲓϩⲉ	sost_asso_egiz_mafe_sipl
ⲙⲟⲉⲓⲧ	sost_asso_egiz_masc_sipl
ⲙⲟⲓϩⲉ	sost_asso_egiz_mafe_sipl
ⲙⲟⲛⲁⲥⲧⲏⲣⲓⲟⲛ	sost_grec_masc_sipl
ⲙⲟⲛⲁⲭⲏ	sost_grec_femm_sipl
ⲙⲟⲛⲁⲭⲟⲥ	sost_grec_masc_sipl
ⲙⲟⲛⲟⲅⲉⲛⲏⲥ	sost_grec_masc_sipl
ⲙⲟⲛⲟⲕⲉⲣⲱⲥ	sost_grec_masc_sipl
ⲙⲟⲛⲟⲭⲟⲥ	sost_grec_masc_sipl
ⲙⲟⲟⲩ	sost_asso_egiz_masc_sipl
ⲙⲟⲣⲧ	sost_asso_egiz_femm_sipl
ⲙⲟⲣⲫⲏ	sost_grec_femm_sipl
ⲙⲟⲧⲛⲉⲥ	sost_asso_egiz_femm_sipl
ⲙⲟⲩ	sost_verb_asso
ⲙⲟⲩⲉⲓⲟⲟⲩⲉ	sost_asso_egiz_plur
ⲙⲟⲩⲓ	sost_asso_egiz_mafe_sipl
ⲙⲟⲩⲓⲟⲟⲩⲉ	sost_asso_egiz_plur
ⲙⲟⲩⲛϩⲱⲟⲩ	sost_asso_egiz_masc_sipl
ⲙⲟⲩⲛⲅ	sost_asso_egiz_masc_sipl
ⲙⲟⲩⲛⲉⲓⲟⲟⲩⲉ	sost_asso_egiz_masc_sipl
ⲙⲟⲩⲛⲕ	sost_asso_egiz_masc_sipl
ⲙⲟⲩⲥ
ⲙⲟⲩⲥⲓⲕⲟⲛ	sost_grec_masc_sipl
ⲙⲟⲩⲧ	sost_asso_egiz_masc_sipl
ⲙⲟⲭⲗⲟⲥ	sost_grec_masc_sipl
ⲙⲡϣⲁ	sost_verb_asso
ⲙⲣⲣⲉ	sost_asso_egiz_femm_sipl
ⲙⲣⲱ	sost_asso_egiz_femm_sipl
ⲙⲥⲁϩ	sost_asso_egiz_masc_sipl
ⲙⲧⲟ	sost_asso_egiz_masc_sipl
ⲙⲧⲟⲛ	sost_verb_asso
ⲙⲧⲟⲛⲛϩⲏⲧ	sost_asso_egiz_masc_sipl
ⲙⲧⲱ	sost_asso_egiz_femm_sipl
ⲙⲩⲥⲧⲏⲣⲓⲟⲛ	sost_grec_masc_sipl
ⲙⲱⲙϣ	sost_asso_egiz_masc_sipl
ⲛ	refe_partrefe_dimo_artinegatripconvprep_nomi_egizattrsost_verb_nomisost_verb_pron
ⲛϣⲟⲧ	sost_asso_egiz_masc_sipl
ⲛⲁϣⲧϩⲏⲧ	sost_asso_egiz_mafe_sipl
ⲛⲁϩⲃ	sost_asso_egiz_masc_sipl
ⲛⲁϫϩⲉ	sost_asso_egiz_femm_sipl
ⲛⲁⲁϫⲉ	sost_asso_egiz_masc_sipl
ⲛⲁⲁⲕⲉ	sost_asso_egiz_femm_sipl
ⲛⲁⲍⲱⲣⲁⲓⲟⲥ
ⲛⲁⲏⲧ	sost_asso_egiz_mafe_sipl
ⲛⲁⲩ	sost_asso_egiz_masc_siplsost_verb_asso
ⲛⲉϩ	sost_asso_egiz_masc_siplsost_verb_nomi
ⲛⲉⲉⲃⲉ	sost_asso_egiz_masc_sipl
ⲛⲉⲑⲏⲡ	sost_asso_egiz_plur
ⲛⲉⲕⲣⲟⲥ	sost_grec_masc_sipl
ⲛⲉⲙⲫⲏ	sost_grec_femm_sipl
ⲛⲉⲛⲉⲣⲏⲟⲩ	sost_asso_egiz_plur
ⲛⲉⲛⲉⲣⲏⲩ	sost_asso_egiz_plur
ⲛⲉⲥϯⲁ	sost_grec_femm_sipl
ⲛⲉⲥⲉⲣⲏⲩ	sost_asso_egiz_plur
ⲛⲉⲥⲧⲟⲣⲓⲁⲛⲟⲥ	sost_grec_masc_sipl
ⲛⲉⲥⲧⲱⲣⲓⲁⲛⲟⲥ	sost_grec_masc_sipl
#ⲛⲉⲧϩⲓⲧⲟⲩⲱ
#ⲛⲉⲧⲙⲟⲟⲩⲧ
#ⲛⲉⲧⲛⲉⲣⲏⲩ
#ⲛⲉⲧⲟⲩⲁⲁⲃ
#ⲛⲉⲧⲧⲁⲓⲏⲩ
ⲛⲉⲩⲉⲣⲏⲟⲩ	sost_asso_egiz_plur
ⲛⲉⲩⲉⲣⲏⲩ	sost_asso_egiz_plur
ⲛⲏⲥⲟⲥ	sost_grec_femm_sipl
ⲛⲏⲥⲧⲉⲓⲁ	sost_grec_femm_sipl
ⲛⲏⲥⲧⲓⲁ	sost_grec_femm_sipl
ⲛⲓⲕⲏ	sost_asso_egiz_femm_sipl
ⲛⲓⲕⲏⲧⲏⲥ	sost_grec_masc_sipl
ⲛⲕⲁ	sost_asso_egiz_masc_sipl
ⲛⲕⲁⲛⲓⲙ	sost_asso_egiz_masc_sipl
ⲛⲟϥⲣⲉ	sost_asso_egiz_masc_sipl
ⲛⲟϭ	sost_asso_egiz_mafe_sipl
ⲛⲟϭⲙⲡⲟⲗⲓⲥ	sost_asso_egiz_femm_sipl
ⲛⲟϭⲛϭⲟⲙ	sost_asso_egiz_masc_sipl
ⲛⲟϭⲛϭⲱⲛⲧ	sost_asso_egiz_mafe_sipl
ⲛⲟϭⲛⲉϭⲟⲙ	sost_asso_egiz_masc_sipl
ⲛⲟⲃⲉ	sost_asso_egiz_masc_sipl
ⲛⲟⲃⲣⲉ	sost_asso_egiz_masc_sipl
ⲛⲟⲉⲃⲣⲓⲟⲥ	sost_grec_masc_sipl
ⲛⲟⲉⲓⲕ	sost_asso_egiz_masc_sipl
ⲛⲟⲉⲣⲁ	sost_grec_femm
ⲛⲟⲉⲣⲟⲛ	sost_grec_masc_sipl
ⲛⲟⲉⲣⲟⲥ	sost_grec_masc_sipl
ⲛⲟⲏⲙⲁ	sost_grec_masc_sipl
ⲛⲟⲙⲓⲕⲟⲥ	sost_grec_masc_sipl
ⲛⲟⲙⲟⲑⲉⲧⲏⲥ	sost_grec_masc_sipl
ⲛⲟⲙⲟⲥ	sost_grec_masc_sipl
ⲛⲟⲙⲧⲉ	sost_asso_egiz_masc_sipl
ⲛⲟⲧⲁⲣⲓⲟⲥ	sost_grec_masc_sipl
ⲛⲟⲩϩ	sost_asso_egiz_masc_sipl
ⲛⲟⲩϭⲥ	sost_verb_asso
ⲛⲟⲩⲃ	sost_asso_egiz_masc_sipl
ⲛⲟⲩⲙⲉⲣⲟⲥ	sost_grec_masc_sipl
ⲛⲟⲩⲛ	sost_asso_egiz_masc_sipl
ⲛⲟⲩⲛⲉ	sost_asso_egiz_femm_siplsost_asso_egiz_femm_sipl
ⲛⲟⲩⲥ	sost_grec_masc_sipl
ⲛⲟⲩⲧⲉ	sost_asso_egiz_masc_sipl
ⲛⲧⲏϭ	sost_asso_egiz_masc_sipl
ⲛⲩⲙⲫⲏ	sost_grec_femm_sipl
ⲛⲩⲙⲫⲓⲟⲥ	sost_grec_masc_sipl
ⲝⲉⲥⲧⲏⲥ	sost_grec_masc_siplsost_grec_masc_sipl
ⲝⲟⲩⲣ	sost_asso_egiz_masc_sipl
ⲟϩⲉ	sost_asso_egiz_masc_sipl
ⲟⲃϩⲉ	sost_asso_egiz_femm_sipl
ⲟⲉⲓⲕ	sost_asso_egiz_masc_sipl
ⲟⲓⲕⲟⲇⲟⲙⲏ	sost_grec_femm_sipl
ⲟⲓⲕⲟⲛⲟⲙⲓⲁ	sost_grec_femm_sipl
ⲟⲓⲕⲟⲛⲟⲙⲟⲥ	sost_grec_masc_sipl
ⲟⲓⲕⲟⲩⲙⲉⲛⲏ	sost_grec_masc_sipl
ⲟⲓⲕⲟⲩⲙⲛⲏ	sost_grec_femm_sipl
ⲟⲙⲉ	sost_asso_egiz_mafe_sipl
ⲟⲛⲟⲙⲁⲥⲧⲟⲥ	sost_grec_masc_sipl
ⲟⲟϩ	sost_asso_egiz_masc_sipl
ⲟⲟⲙⲉ	sost_asso_egiz_masc_sipl
ⲟⲟⲧⲉ	sost_asso_egiz_femm_sipl
ⲟⲣⲅⲁⲛⲟⲛ	sost_grec_masc_sipl
ⲟⲣⲅⲏ	sost_grec_femm_sipl
ⲟⲣⲇⲓⲛⲟⲛ	sost_grec_masc_sipl
ⲟⲣⲑⲟⲇⲟⲝⲟⲥ	sost_grec_masc_sipl
ⲟⲥⲉ	sost_asso_egiz_masc_sipl
ⲟⲩϣⲏ	sost_asso_egiz_femm_sipl
ⲟⲩϣⲏⲛⲣⲟⲉⲓⲥ	sost_asso_egiz_masc_sipl
ⲟⲩϣⲟⲟⲩⲉ	sost_asso_egiz_plur
ⲟⲩϩⲟⲟⲣ	sost_asso_egiz_plur
ⲟⲩϭⲁⲥ	nume
ⲟⲩⲁ	sost_asso_egiz_masc_siplnume
ⲟⲩⲁϩⲉ	sost_asso_egiz_masc_sipl
ⲟⲩⲁϩⲉⲧ	sost_asso_egiz_mafe_sipl
ⲟⲩⲁϩⲓⲏⲧ	sost_asso_egiz_mafe_sipl
ⲟⲩⲁⲙⲟⲙⲉ	sost_asso_egiz_femm_sipl
ⲟⲩⲁⲙⲣⲱⲙⲉ	sost_asso_egiz_mafe_sipl
ⲟⲩⲁⲛⲟⲩⲱⲧ	sost_asso_egiz_mafe_sipl
ⲟⲩⲉ	sost_verb_asso
ⲟⲩⲉⲓ	sost_asso_egiz_femm_sipl
ⲟⲩⲉⲣⲏⲧⲉ	sost_asso_egiz_plur
ⲟⲩⲏⲉⲓⲃ	sost_asso_egiz_mafe_sipl
ⲟⲩⲏⲏⲃ	sost_asso_egiz_mafe_sipl
ⲟⲩⲏⲧ	sost_asso_egiz_masc_sipl
ⲟⲩⲗⲗⲉ	sost_asso_egiz_masc_sipl
ⲟⲩⲛⲁⲙ	sost_asso_egiz_masc_sipl
ⲟⲩⲛⲟⲩ	sost_asso_egiz_femm_sipl
ⲟⲩⲟⲉⲓ	sost_asso_egiz_masc_sipl
ⲟⲩⲟⲉⲓϣ	sost_asso_egiz_masc_sipl
ⲟⲩⲟⲉⲓⲉ	sost_asso_egiz_masc_sipl
ⲟⲩⲟⲉⲓⲏ	sost_asso_egiz_plur
ⲟⲩⲟⲉⲓⲛ	sost_asso_egiz_masc_sipl
ⲟⲩⲟⲓ	sost_asso_egiz_masc_sipl
ⲟⲩⲟⲙϥ	sost_asso_egiz_masc_sipl
ⲟⲩⲟⲛ	sost_asso_egiz_mafe_sipl
ⲟⲩⲟⲛϩⲛⲛ	sost_asso_egiz_mafe_sipl
ⲟⲩⲟⲛⲛⲓⲙ	sost_asso_egiz_mafe_sipl
ⲟⲩⲡⲉⲡⲁⲓ	sost_asso_egiz_mafe_sipl
ⲟⲩⲣⲟⲧ	sost_verb_asso
ⲟⲩⲥⲓⲁ	sost_grec_femm_sipl
ⲟⲩⲱϣ	sost_verb_asso
ⲟⲩⲱϩⲉ	sost_asso_egiz_masc_sipl
ⲟⲩⲱⲗⲥⲛϩⲏⲧ	sost_asso_egiz_femm_sipl
ⲟⲩⲱⲙ	sost_verb_asso
ⲟⲩⲱⲛϣ	sost_asso_egiz_masc_sipl
ⲟⲩⲱⲧ	sost_asso_egiz_masc_sipl
ⲟⲫⲉⲗⲉⲓⲁ	sost_grec_femm_sipl
ⲡⲁϣⲉ
ⲡⲁϩⲣⲉ	sost_asso_egiz_femm_sipl
ⲡⲁϭⲉⲛϣⲉ	sost_asso_egiz_masc_sipl
ⲡⲁⲅⲁⲛⲟⲥ	sost_grec_masc_sipl
ⲡⲁⲅⲁⲣⲭⲟⲥ	sost_grec_masc_sipl
ⲡⲁⲑⲏⲧⲟⲥ	sost_grec_masc_sipl
ⲡⲁⲑⲟⲥ	sost_grec_masc_sipl
ⲡⲁⲓⲇⲉⲓⲁ	sost_grec_femm_sipl
ⲡⲁⲓⲇⲉⲩⲥⲓⲥ	sost_grec_femm_sipl
ⲡⲁⲓⲇⲓⲁ	sost_grec_femm_sipl
ⲡⲁⲗⲁϯⲟⲛ	sost_grec_masc_sipl
ⲡⲁⲗⲁⲓⲁ	sost_grec_femm_sipl
ⲡⲁⲗⲁⲧⲓⲟⲛ	sost_grec_masc_sipl
ⲡⲁⲗⲗⲁϯⲟⲛ	sost_grec_masc_sipl
ⲡⲁⲗⲗⲁⲇⲓⲟⲛ	sost_grec_masc_sipl
ⲡⲁⲗⲗⲁⲧⲓⲟⲛ	sost_grec_masc_sipl
ⲡⲁⲛⲓⲡⲉ	sost_asso_egiz_masc_sipl
ⲡⲁⲛⲟⲡⲟⲗⲓⲧⲏⲥ	sost_grec_masc_sipl
ⲡⲁⲛⲧⲟⲕⲣⲁⲧⲱⲣ	sost_grec_masc_sipl
ⲡⲁⲟⲡⲉ	sost_asso_egiz_masc_sipl
ⲡⲁⲡⲁⲥ	sost_grec_masc_sipl
ⲡⲁⲣϩⲟⲓⲙⲓⲁ	sost_grec_femm_sipl
ⲡⲁⲣⲁⲃⲁⲥⲓⲥ	sost_grec_femm_sipl
ⲡⲁⲣⲁⲃⲟⲗⲏ	sost_grec_femm_sipl
ⲡⲁⲣⲁⲅⲅⲉⲗⲓⲁ	sost_grec_femm_sipl
ⲡⲁⲣⲁⲇⲉⲓⲅⲙⲁ	sost_grec_masc_sipl
ⲡⲁⲣⲁⲇⲉⲓⲥⲟⲥ	sost_grec_masc_sipl
ⲡⲁⲣⲁⲇⲓⲅⲙⲁ	sost_grec_masc_sipl
ⲡⲁⲣⲁⲇⲓⲥⲟⲥ	sost_grec_masc_sipl
ⲡⲁⲣⲁⲇⲓⲥⲱⲥ	sost_grec_masc_sipl
ⲡⲁⲣⲁⲇⲟⲥⲓⲥ	sost_grec_femm_sipl
ⲡⲁⲣⲁⲑⲏⲕⲏ	sost_grec_femm_sipl
ⲡⲁⲣⲁⲕⲗⲏⲥⲓⲥ	sost_grec_femm_sipl
ⲡⲁⲣⲁⲕⲗⲏⲧⲟⲥ	sost_grec_masc_sipl
ⲡⲁⲣⲁⲛⲟⲙⲓⲁ	sost_grec_femm_sipl
ⲡⲁⲣⲁⲛⲟⲙⲟⲛ	sost_grec_masc_sipl
ⲡⲁⲣⲁⲛⲟⲙⲟⲥ	sost_grec_masc_sipl
ⲡⲁⲣⲁⲛⲱⲙⲓⲁ	sost_grec_femm_sipl
ⲡⲁⲣⲁⲥⲕⲉⲩⲏ	sost_grec_femm_sipl
ⲡⲁⲣⲁⲥⲧⲁⲧⲏⲥ	sost_grec_masc_sipl
ⲡⲁⲣⲑⲉⲛⲓⲁ	sost_grec_femm_sipl
ⲡⲁⲣⲑⲉⲛⲟⲥ	sost_grec_femm_sipl
ⲡⲁⲣⲟⲩⲥⲓⲁ	sost_grec_femm_sipl
ⲡⲁⲣⲣⲏⲥⲓⲁ	sost_grec_femm_sipl
ⲡⲁⲣⲣⲟⲩⲥⲓⲁ	sost_grec_femm_sipl
ⲡⲁⲥ	sost_asso_egiz_masc_sipl
ⲡⲁⲥⲭⲁ	sost_grec_masc_sipl
ⲡⲁⲧ	sost_asso_egiz_masc_sipl
ⲡⲁⲧⲣⲓⲁⲣⲭⲏⲥ	sost_grec_masc_sipl
ⲡⲉ	pleorefe_dimo_artirefe_dimo_pronrefe_dimo_bipnrefe_dimo_relasost_asso_egiz_femm_sipl
ⲡⲉⲇⲉⲩⲥⲓⲥ	sost_grec_femm_sipl
ⲡⲉⲇⲏⲥ	sost_grec_masc_sipl
ⲡⲉⲑⲏⲡ	sost_asso_egiz_masc_sing
ⲡⲉⲑⲓⲧⲟⲩⲱ	sost_egiz_pron
ⲡⲉⲑⲟⲟⲩ	sost_asso_egiz_masc_sipl
ⲡⲉⲓⲣⲁⲥⲙⲟⲥ	sost_grec_masc_sipl
ⲡⲉⲗⲁⲅⲟⲥ	sost_grec_masc_sipl
ⲡⲉⲛⲓⲡⲉ	sost_asso_egiz_masc_siplsost_asso_egiz_masc_sipl
ⲡⲉⲣⲓⲉⲣⲅⲟⲥ	sost_grec_masc_sipl
ⲡⲉⲣⲓⲥⲡⲁⲥⲙⲟⲥ	sost_grec_masc_sipl
ⲡⲉⲣⲥⲓⲧⲏⲥ	sost_grec_masc_sipl
#ⲡⲉⲧϣⲟⲩⲉⲓⲧ
#ⲡⲉⲧϣⲟⲩⲱⲟⲩ
#ⲡⲉⲧϩⲓⲧⲟⲩⲱ
#ⲡⲉⲧⲉϣϣⲉ
#ⲡⲉⲧⲉϩⲛⲁ
#ⲡⲉⲧⲉⲩⲥⲓⲥ
#ⲡⲉⲧⲙⲙⲁⲩ
#ⲡⲉⲧⲙⲟⲟⲩⲧ
#ⲡⲉⲧⲛⲁⲛⲟⲩϥ
#ⲡⲉⲧⲛⲁⲛⲟⲩⲟⲩ
#ⲡⲉⲧⲟⲩⲁⲁⲃ
#ⲡⲉⲧⲥⲏϩ
#ⲡⲉⲧⲥⲟⲩⲧⲱⲛ
ⲡⲏⲅⲏ	sost_grec_femm_sipl
ⲡⲏⲟⲩⲉ	sost_asso_egiz_plur
ⲡⲏⲩⲉ	sost_asso_egiz_plur
ⲡⲓⲛⲁⲝ	sost_grec_masc_sipl
ⲡⲓⲣⲁⲥⲙⲟⲥ	sost_grec_masc_sipl
ⲡⲓⲥⲧⲏⲥ	sost_grec_femm_sipl
ⲡⲓⲥⲧⲓⲥ	sost_grec_femm_sipl
ⲡⲓⲥⲧⲟⲥ	sost_grec_masc_sipl
ⲡⲗϭⲉ	sost_asso_egiz_masc_sipl
ⲡⲗⲁϯⲁ	sost_grec_femm_sipl
ⲡⲗⲁⲕⲟⲩⲧⲟⲛ	sost_grec_masc_sipl
ⲡⲗⲁⲕⲩⲧⲟⲛ	sost_grec_masc_sipl
ⲡⲗⲁⲕⲱⲧⲟⲛ	sost_grec_masc_sipl
ⲡⲗⲁⲛⲏ	sost_grec_femm_sipl
ⲡⲗⲁⲝ	sost_grec_masc_sipl
ⲡⲗⲁⲥⲓⲥ	sost_grec_femm_sipl
ⲡⲗⲁⲥⲙⲁ	sost_grec_masc_sipl
ⲡⲗⲁⲧⲉⲓⲁ	sost_grec_femm_sipl
ⲡⲗⲁⲧⲓⲁ	sost_grec_femm_sipl
ⲡⲗⲉⲟⲛⲉⲕⲧⲏⲥ	sost_grec_masc_sipl
ⲡⲗⲉⲟⲛⲉⲝⲓⲁ	sost_grec_femm_sipl
ⲡⲗⲏⲅⲏ	sost_grec_femm_sipl
ⲡⲗⲏⲣⲟⲫⲟⲣⲓⲁ	sost_grec_femm_sipl
ⲡⲗⲏⲣⲱⲙⲁ	sost_grec_masc_sipl
ⲡⲛⲉⲩⲙⲁ	sost_grec_masc_sipl
ⲡⲛⲉⲩⲙⲁⲧⲓⲕⲟⲛ	sost_grec_masc_sipl
ⲡⲛⲉⲩⲙⲁⲧⲓⲕⲟⲥ	sost_grec_masc_sipl
ⲡⲛⲉⲩⲙⲁⲧⲟⲫⲟⲣⲟⲥ	sost_grec_masc_sipl
ⲡⲛⲟⲏ	sost_grec_femm_sipl
ⲡⲟⲓⲏⲧⲏⲥ	sost_grec_masc_sipl
ⲡⲟⲗⲉⲓⲥ	sost_grec_femm_sipl
ⲡⲟⲗⲉⲙⲁⲣⲭⲏⲥ	sost_grec_masc_sipl
ⲡⲟⲗⲉⲙⲓⲥⲧⲏⲥ	sost_grec_masc_sipl
ⲡⲟⲗⲉⲙⲟⲥ	sost_grec_masc_sipl
ⲡⲟⲗⲓⲥ	sost_grec_femm_sipl
ⲡⲟⲗⲓⲧⲉⲓⲁ	sost_grec_femm_sipl
ⲡⲟⲗⲓⲧⲉⲩⲙⲁ	sost_grec_masc_sipl
ⲡⲟⲗⲓⲧⲉⲩⲧⲏⲥ	sost_grec_masc_sipl
ⲡⲟⲗⲓⲧⲓⲁ	sost_grec_femm_sipl
ⲡⲟⲗⲗⲩⲗⲟⲅⲟⲥ	sost_grec_masc_sipl
ⲡⲟⲗⲩϯⲁ	sost_grec_femm_sipl
ⲡⲟⲗⲩⲗⲟⲅⲟⲥ	sost_grec_masc_sipl
ⲡⲟⲗⲩⲙⲟⲥ	sost_grec_masc_sipl
ⲡⲟⲛⲉⲣⲟⲥ	sost_grec_masc_sipl
ⲡⲟⲛⲏⲣⲓⲁ	sost_grec_femm_sipl
ⲡⲟⲛⲏⲣⲟⲛ	sost_grec_masc_sipl
ⲡⲟⲛⲏⲣⲟⲥ	sost_grec_masc_sipl
ⲡⲟⲣⲛⲉⲓⲁ	sost_grec_femm_sipl
ⲡⲟⲣⲛⲏ	sost_grec_femm_sipl
ⲡⲟⲣⲛⲓⲁ	sost_grec_femm_sipl
ⲡⲟⲣⲫⲏⲣⲁ	sost_grec_femm_sipl
ⲡⲟⲣⲫⲓⲣⲁ	sost_grec_femm_sipl
ⲡⲟⲣⲫⲩⲣⲁ	sost_grec_femm_sipl
ⲡⲟⲧⲏⲣⲓⲟⲛ	sost_grec_masc_sipl
ⲡⲟⲩⲁⲇⲉⲡⲟⲩⲁ	sost_asso_egiz_masc_sipl
ⲡⲟⲩⲁⲡⲟⲩⲁ	sost_asso_egiz_mafe_sipl
ⲡⲣⲁⲅⲇⲟⲥ	sost_grec_masc_sipl
ⲡⲣⲁⲅⲙⲁⲧⲉⲩⲧⲏⲥ	sost_grec_masc_sipl
ⲡⲣⲁⲅⲧⲟⲥ	sost_grec_masc_sipl
ⲡⲣⲁⲓⲧⲁⲛⲓⲁ	sost_grec_femm_sipl
ⲡⲣⲁⲓⲧⲱⲣⲓⲟⲛ	sost_grec_masc_sipl
ⲡⲣⲁⲕⲇⲟⲥ	sost_grec_masc_sipl
ⲡⲣⲁⲕⲧⲓⲕⲟⲛ	sost_grec_masc_sipl
ⲡⲣⲁⲕⲧⲟⲥ	sost_grec_masc_sipl
ⲡⲣⲁⲝⲓⲥ	sost_grec_masc_sipl
ⲡⲣⲉⲥⲃⲩⲧⲉⲣⲟⲥ	sost_grec_masc_sipl
ⲡⲣⲉⲥⲃⲩⲧⲏⲣⲟⲥ	sost_grec_masc_sipl
ⲡⲣⲏϣ
ⲡⲣⲟϩⲁⲓⲣⲉⲥⲓⲥ	sost_grec_femm_sipl
ⲡⲣⲟϩⲁⲓⲣⲏⲥⲓⲥ	sost_grec_femm_sipl
ⲡⲣⲟϩⲉⲣⲉⲥⲓⲥ	sost_grec_femm_sipl
ⲡⲣⲟϩⲉⲣⲏⲥⲓⲥ	sost_grec_femm_sipl
ⲡⲣⲟⲅⲛⲱⲥⲧⲏⲥ	sost_grec_masc_sipl
ⲡⲣⲟⲇⲟⲥⲓⲁ	sost_grec_femm_sipl
ⲡⲣⲟⲇⲣⲟⲙⲟⲥ	sost_grec_masc_sipl
ⲡⲣⲟⲑⲉⲙⲓⲁ	sost_grec_femm_sipl
ⲡⲣⲟⲑⲩⲙⲓⲁ	sost_grec_femm_sipl
ⲡⲣⲟⲕⲟⲡⲏ	sost_grec_femm_sipl
ⲡⲣⲟⲛⲓⲁ	sost_grec_femm_sipl
ⲡⲣⲟⲛⲟⲓⲁ	sost_grec_femm_sipl
ⲡⲣⲟⲥⲇⲟⲕⲓⲁ	sost_grec_femm_sipl
ⲡⲣⲟⲥⲉⲩⲭⲏ	sost_grec_femm_sipl
ⲡⲣⲟⲥⲟⲇⲟⲥ	sost_grec_masc_sipl
ⲡⲣⲟⲥⲟⲡⲟⲛ	sost_grec_masc_sipl
ⲡⲣⲟⲥⲧⲁⲅⲙⲁ	sost_grec_masc_sipl
ⲡⲣⲟⲥⲧⲁⲥⲓⲁ	sost_grec_femm_sipl
ⲡⲣⲟⲥⲫⲟⲣⲁ	sost_grec_femm_sipl
ⲡⲣⲟⲥⲫⲱⲣⲁ	sost_grec_femm_sipl
ⲡⲣⲟⲥⲱⲡⲟⲛ	sost_grec_masc_sipl
ⲡⲣⲟⲧⲣⲉⲡⲧⲓⲕⲟⲛ	sost_grec_masc_sipl
ⲡⲣⲟⲧⲣⲟⲡⲏ	sost_grec_femm_sipl
ⲡⲣⲟⲫⲁⲥⲓⲥ	sost_grec_femm_sipl
ⲡⲣⲟⲫⲏⲧⲏⲥ	sost_grec_masc_sipl
ⲡⲣⲟⲫⲏⲧⲓⲁ	sost_grec_femm_sipl
ⲡⲣⲱ	sost_asso_egiz_femm_sipl
ⲡⲣⲱⲧⲟⲕⲟⲓⲙⲏⲗⲓⲁⲣⲭⲏⲥ	sost_grec_masc_sipl
ⲡⲩⲗⲏ	sost_grec_femm_sipl
ⲡⲩⲣⲅⲟⲥ	sost_grec_femm_sipl
ⲡⲱⲛⲩⲣⲓⲁ	sost_grec_femm_sipl
ⲡⲱⲧⲏⲣⲓⲟⲛ	sost_grec_masc_sipl
ⲡⲱⲱⲛⲉ	sost_verb_asso
ⲣ	sost_verb_nomi
ⲣⲁⲛ	sost_asso_egiz_masc_sipl
ⲣⲁⲥⲟⲩ	sost_asso_egiz_masc_sipl
ⲣⲁⲥⲧⲉ	sost_asso_egiz_masc_sipl
ⲣⲁⲧ	sost_egiz_pron
ⲣⲉϥϣⲁϫⲉ	sost_asso_egiz_mafe_sipl
ⲣⲉϥϣⲉⲙϣⲉⲉⲓⲇⲟⲗⲟⲛ	sost_asso_egiz_mafe_sipl
ⲣⲉϥϣⲉⲙϣⲉⲛⲟⲩⲧⲉ	sost_asso_egiz_mafe_sipl
ⲣⲉϥϣⲙϣⲉⲉⲓⲇⲱⲗⲟⲛ	sost_asso_egiz_mafe_sipl
ⲣⲉϥϣⲙϣⲉⲛⲟⲩⲧⲉ	sost_asso_egiz_mafe_sipl
ⲣⲉϥϣⲡϩⲓⲥⲉ	sost_asso_egiz_mafe_sipl
ⲣⲉϥϣⲱⲛⲉ	sost_asso_egiz_mafe_sipl
ⲣⲉϥϣⲱⲥ	sost_asso_egiz_mafe_sipl
ⲣⲉϥϩⲉⲧⲃⲛⲟⲩⲧⲉ	sost_asso_egiz_mafe_sipl
ⲣⲉϥϩⲉⲧⲃⲣⲱⲙⲉ	sost_asso_egiz_mafe_sipl
ⲣⲉϥϩⲉⲧⲃⲯⲩⲭⲏ	sost_asso_egiz_mafe_sipl
ⲣⲉϥϩⲱⲧⲃ	sost_egiz_nomi
ⲣⲉϥϫⲉϭⲟⲗ	sost_asso_egiz_mafe_sipl
ⲣⲉϥϫⲉϭⲥⲟⲣⲧ	sost_asso_egiz_mafe_sipl
ⲣⲉϥϫⲓϣⲟϫⲛⲉ	sost_asso_egiz_mafe_sipl
ⲣⲉϥϫⲓϭⲟⲗ	sost_asso_egiz_mafe_sipl
ⲣⲉϥϫⲓⲛϭⲟⲛⲉⲥ	sost_asso_egiz_mafe_sipl
ⲣⲉϥϫⲓⲛϭⲟⲛⲥ	sost_asso_egiz_mafe_sipl
ⲣⲉϥϫⲣⲟ	sost_asso_egiz_mafe_sipl
ⲣⲉϥϯⲙⲛⲧⲛⲁ	sost_asso_egiz_mafe_sipl
ⲣⲉϥϯⲣⲁⲥⲟⲩ	sost_asso_egiz_mafe_sipl
ⲣⲉϥϯⲥⲃⲱ	sost_asso_egiz_mafe_sipl
ⲣⲉϥⲁⲣⲉⲥⲕⲉ	sost_asso_egiz_mafe_sipl
ⲣⲉϥⲇⲓⲁⲕⲟⲛⲉⲓ	sost_asso_egiz_mafe_sipl
ⲣⲉϥⲉⲓⲣⲉ	sost_asso_egiz_mafe_sipl
ⲣⲉϥⲉⲣϩⲟⲧⲉ	sost_asso_egiz_mafe_sipl
ⲣⲉϥⲉⲣⲛⲟⲃⲉ	sost_asso_egiz_mafe_sipl
ⲣⲉϥⲉⲣⲡⲁϩⲣⲉ	sost_asso_egiz_mafe_sipl
ⲣⲉϥⲉⲣⲡⲉⲑⲟⲟⲩ	sost_asso_egiz_mafe_sipl
ⲣⲉϥⲕⲁⲗⲉⲓ	sost_asso_egiz_mafe_sipl
ⲣⲉϥⲕⲁⲥⲕⲥ	sost_asso_egiz_mafe_sipl
ⲣⲉϥⲕⲁⲧⲁⲗⲁⲗⲉⲓ	sost_asso_egiz_mafe_sipl
ⲣⲉϥⲕⲣⲟⲙⲣⲉⲙ	sost_asso_egiz_mafe_sipl
ⲣⲉϥⲕⲣⲟⲙⲣⲙ	sost_asso_egiz_mafe_sipl
ⲣⲉϥⲗⲟⲕⲥ	sost_asso_egiz_mafe_sipl
ⲣⲉϥⲗⲱⲕⲥ	sost_egiz_nomi
ⲣⲉϥⲙⲉⲩⲧ	sost_egiz_nomi
ⲣⲉϥⲙⲓϣⲉ	sost_asso_egiz_mafe_sipl
ⲣⲉϥⲙⲟⲟⲛⲉ	sost_asso_egiz_mafe_sipl
ⲣⲉϥⲙⲟⲩⲟⲩⲧ	sost_asso_egiz_mafe_sipl
ⲣⲉϥⲙⲟⲩⲧⲉ	sost_asso_egiz_mafe_sipl
ⲣⲉϥⲡⲉϩⲧⲥⲛⲟϥ	sost_asso_egiz_mafe_sipl
ⲣⲉϥⲡⲉⲣⲉⲣⲁⲥⲟⲩ	sost_asso_egiz_mafe_sipl
ⲣⲉϥⲣϩⲙⲙⲉ	sost_asso_egiz_mafe_sipl
ⲣⲉϥⲣϩⲟⲧⲉ	sost_asso_egiz_mafe_sipl
ⲣⲉϥⲣⲉⲓⲟⲡⲉ	sost_asso_egiz_mafe_sipl
ⲣⲉϥⲣⲛⲟⲃⲉ	sost_asso_egiz_mafe_sipl
ⲣⲉϥⲣⲟⲩⲟⲉⲓⲛ	sost_asso_egiz_mafe_sipl
ⲣⲉϥⲣⲟⲩⲟⲓⲛ	sost_asso_egiz_mafe_sipl
ⲣⲉϥⲣⲡⲁϩⲣⲉ	sost_asso_egiz_mafe_sipl
ⲣⲉϥⲣⲡⲉⲑⲟⲟⲩ	sost_asso_egiz_mafe_sipl
ⲣⲉϥⲣⲱⲕϩ	sost_egiz_nomi
ⲣⲉϥⲥⲉⲥⲛⲟϥ	sost_asso_egiz_mafe_sipl
ⲣⲉϥⲥⲩⲗⲁ	sost_asso_egiz_mafe_sipl
ⲣⲉϥⲥⲱⲛⲧ	sost_asso_egiz_mafe_sipl
ⲣⲉϥⲧⲁⲕⲉⲯⲩⲭⲏ	sost_asso_egiz_mafe_sipl
ⲣⲉϥⲧⲁⲗϭⲟ	sost_asso_egiz_mafe_sipl
ⲣⲉϥⲧⲁⲙⲉⲓⲟ	sost_asso_egiz_mafe_sipl
ⲣⲉϥⲧⲁⲙⲓⲟ	sost_asso_egiz_mafe_sipl
ⲣⲉϥⲧⲁⲛϩⲟ	sost_asso_egiz_mafe_sipl
ⲣⲉϥⲧⲃⲃⲟ	sost_asso_egiz_mafe_sipl
ⲣⲉϥⲧⲱⲣⲡ	sost_asso_egiz_masc_sipl
ⲣⲉϥⲯⲁⲗⲗⲉⲓ	sost_asso_egiz_mafe_sipl
ⲣⲉϥⲱϣ	sost_asso_egiz_mafe_sipl
ⲣⲉⲕⲣⲓⲕⲉ	sost_asso_egiz_masc_sipl
ⲣⲉⲙⲏⲧ	sost_asso_egiz_masc_sipl
ⲣⲉⲙⲓⲟⲟⲩⲉ	sost_asso_egiz_plur
ⲣⲉⲙⲣⲁϣ	sost_asso_egiz_mafe_sipl
ⲣⲏ	sost_asso_egiz_masc_sipl
ⲣⲏⲥ	sost_asso_egiz_masc_sipl
ⲣⲓ	sost_asso_egiz_femm_sipl
ⲣⲓⲙⲉ	sost_verb_asso
ⲣⲓⲣ	sost_asso_egiz_masc_sipl
ⲣⲕⲣⲓⲕⲉ	sost_asso_egiz_masc_sipl
ⲣⲙϩⲉ	sost_asso_egiz_masc_sipl
ⲣⲙϩⲣⲱⲙⲏ	sost_asso_egiz_masc_sipl
ⲣⲙⲉⲓⲏ	sost_asso_egiz_masc_sipl
ⲣⲙⲙⲁⲟ	sost_asso_egiz_masc_sipl
ⲣⲙⲛϩⲏⲧ	sost_asso_egiz_mafe_sipl
ⲣⲙⲛϩⲓⲏ	sost_asso_egiz_masc_sipl
ⲣⲙⲛⲕⲁϩ	sost_asso_egiz_mafe_sipl
ⲣⲙⲛⲕⲏⲙⲉ	sost_asso_egiz_masc_sipl
ⲣⲙⲛⲛⲟⲩⲧⲉ	sost_asso_egiz_masc_sipl
ⲣⲙⲡⲣϭⲟⲩϣ	sost_asso_egiz_masc_sipl
ⲣⲙⲣⲁϣ	sost_asso_egiz_mafe_sipl
ⲣⲙⲣⲁⲕⲟⲧⲉ	sost_asso_egiz_masc_sipl
ⲣⲙⲧⲁⲙⲙⲁ	sost_asso_egiz_masc_sipl
ⲣⲙⲧⲁⲛⲇⲓⲟⲭⲓⲁ	sost_asso_egiz_masc_sipl
ⲣⲟ	sost_asso_egiz_masc_sipl
ⲣⲟⲙⲡⲉ	sost_asso_egiz_femm_sipl
ⲣⲟⲟⲩϣ	sost_asso_egiz_masc_sipl
ⲣⲟⲩϩⲉ	sost_asso_egiz_masc_sipl
ⲣⲡⲉ	sost_asso_egiz_masc_sipl
ⲣⲡⲏⲩⲉ	sost_asso_egiz_plur
ⲣⲣⲟ	sost_asso_egiz_masc_sipl
ⲣⲣⲱ	sost_asso_egiz_femm_sipl
ⲣⲣⲱⲟⲩ	sost_asso_egiz_plur
ⲣⲱ	cong_egizsost_egiz_pron
ⲣⲱⲙⲉ	sost_asso_egiz_mafe_sipl
ⲥϩⲓⲙⲉ	sost_asso_egiz_femm_sing
ⲥϯⲃⲱⲱⲛ	sost_asso_egiz_masc_sipl
ⲥϯⲛⲟⲩϥⲉ	sost_asso_egiz_masc_sipl
ⲥϯⲛⲟⲩⲃⲉ	sost_asso_egiz_masc_sipl
ⲥⲁ	sost_asso_egiz_masc_sipladnu
ⲥⲁϣϥ	nume
ⲥⲁϣϥⲉ	nume
ⲥⲁϩ	sost_asso_egiz_mafe_siplsost_verb_pron
ⲥⲁϩⲟⲩ	sost_verb_asso
ⲥⲁⲃⲃⲁⲧⲟⲛ	sost_grec_masc_sipl
ⲥⲁⲃⲃⲁⲧⲱⲛ	sost_grec_masc_sipl
ⲥⲁⲃⲉ	sost_asso_egiz_mafe_sipl
ⲥⲁⲃⲉⲉⲩ	sost_asso_egiz_plur
ⲥⲁⲃⲉⲗⲗⲓⲟⲥ	sost_grec_masc_sipl
ⲥⲁⲃⲏ	sost_asso_egiz_mafe_sipl
ⲥⲁⲇⲁⲛⲁⲥ	sost_grec_masc_sipl
ⲥⲁⲉⲓⲛ	sost_asso_egiz_mafe_sipl
ⲥⲁⲗⲡⲓⲅⲝ	sost_grec_femm_sipl
ⲥⲁⲙⲁⲣⲓⲧⲏⲥ	sost_grec_masc_sipl
ⲥⲁⲛϩⲟⲩⲛ	sost_asso_egiz_mafe_sipl
ⲥⲁⲛⲃⲟⲗ	sost_asso_egiz_mafe_sipl
ⲥⲁⲣⲁⲅⲉⲛⲟⲥ	sost_grec_masc_sipl
ⲥⲁⲣⲕⲓⲕⲏ	sost_grec_femm_sipl
ⲥⲁⲣⲕⲓⲕⲟⲛ	sost_grec_masc_sipl
ⲥⲁⲣⲕⲓⲕⲟⲥ	sost_grec_masc_sipl
ⲥⲁⲣⲝ	sost_grec_femm_sipl
ⲥⲁⲧ	sost_asso_egiz_masc_sipl
ⲥⲁⲧⲉ	sost_asso_egiz_femm_sipl
ⲥⲃⲟⲉⲓ	sost_asso_egiz_masc_sipl
ⲥⲃⲟⲓ	sost_asso_egiz_masc_sipl
ⲥⲃⲟⲟⲩⲉ	sost_asso_egiz_plur
ⲥⲃⲟⲩⲓ	sost_asso_egiz_plur
ⲥⲃⲱ	sost_asso_egiz_femm_sipl
ⲥⲉ	refe_partnumeinte_egizsost_verb_nomi
ⲥⲉⲓⲛⲑⲏ	sost_asso_egiz_masc_sipl
ⲥⲉⲙⲛⲟⲛ	sost_grec_masc_sipl
ⲥⲉⲛⲧⲉ	nume_spec
ⲥⲏϥⲉ	sost_asso_egiz_femm_sipl
ⲥⲏⲩ	sost_asso_egiz_masc_sipl
ⲥⲓϣⲉ	sost_asso_egiz_masc_sipl
ⲥⲓⲃⲧ	sost_asso_egiz_femm_sipl
ⲥⲓⲛⲟⲩⲥⲓⲁ	sost_grec_femm_sipl
ⲥⲓⲟⲟⲩⲛ	sost_asso_egiz_femm_sipl
ⲥⲓⲟⲩ	sost_asso_egiz_masc_sipl
ⲥⲓⲟⲩⲣ	sost_asso_egiz_masc_sipl
ⲥⲕⲁⲛⲇⲁⲗⲟⲛ	sost_grec_masc_sipl
ⲥⲕⲁⲫⲟⲥ	sost_grec_masc_sipl
ⲥⲕⲉⲛⲏ	sost_grec_femm_sipl
ⲥⲕⲉⲡⲧⲱⲣ	sost_grec_masc_sipl
ⲥⲕⲉⲩⲉ	sost_grec_plur
ⲥⲕⲉⲩⲏ	sost_grec_femm_sipl
ⲥⲕⲉⲩⲟⲥ	sost_grec_masc_sipl
ⲥⲕⲏⲛⲏ	sost_grec_femm_sipl
ⲥⲕⲏⲡⲏ	sost_grec_femm_sipl
ⲥⲕⲟⲡⲟⲥ	sost_grec_masc_sipl
ⲥⲕⲣⲱⲫⲁ	sost_grec_masc_sipl
ⲥⲕⲩⲗⲙⲟⲥ	sost_grec_masc_sipl
ⲥⲕⲩⲛⲏ	sost_grec_femm_sipl
ⲥⲙⲏ	sost_asso_egiz_femm_sipl
ⲥⲙⲙⲉ	sost_verb_asso
ⲥⲙⲟⲧ	sost_asso_egiz_masc_sipl
ⲥⲛⲁⲩ	nume
ⲥⲛⲁⲩϩ	sost_asso_egiz_masc_sipl
ⲥⲛⲏⲟⲩ	sost_asso_egiz_plur
ⲥⲛⲏⲩ	sost_asso_egiz_plur
ⲥⲛⲟϥ	sost_asso_egiz_masc_sipl
ⲥⲛⲧⲉ	sost_asso_egiz_masc_siplnume_spec
ⲥⲛⲱⲱϥ	sost_asso_egiz_plur
ⲥⲟ	nume
ⲥⲟϭ	sost_asso_egiz_masc_sipl
ⲥⲟⲃⲧ	sost_asso_egiz_masc_sipl
ⲥⲟⲉⲓⲧ	sost_asso_egiz_masc_sipl
ⲥⲟⲛ	sost_asso_egiz_masc_sipl
ⲥⲟⲛⲧⲉ	sost_asso_egiz_masc_sipl
ⲥⲟⲟⲛⲉ	sost_asso_egiz_masc_sipl
ⲥⲟⲟⲩ	nume
ⲥⲟⲟⲩϩⲉ	sost_asso_egiz_femm_sipl
ⲥⲟⲟⲩϩⲥ	sost_asso_egiz_femm_sipl
ⲥⲟⲟⲩⲛ	sost_verb_asso
ⲥⲟⲟⲩⲛϣⲟ	nume
ⲥⲟⲡ	sost_asso_egiz_masc_sipl
ⲥⲟⲣⲧ	sost_asso_egiz_mafe_sipl
ⲥⲟⲧⲃⲉϥ	sost_asso_egiz_masc_sipl
ⲥⲟⲧⲉ	sost_asso_egiz_masc_sipl
ⲥⲟⲩ	refe_partadnu
ⲥⲟⲩⲟ	sost_asso_egiz_masc_sipl
ⲥⲟⲩⲣⲉ	sost_asso_egiz_femm_sipl
ⲥⲟⲫⲓⲁ	sost_grec_femm_sipl
ⲥⲟⲫⲓⲥⲧⲏⲥ	sost_grec_masc_sipl
ⲥⲟⲫⲟⲥ	sost_grec_masc_sipl
ⲥⲡⲁⲑⲁⲣⲓⲟⲥ	sost_grec_masc_sipl
ⲥⲡⲉⲗⲁⲓⲟⲛ	sost_grec_masc_sipl
ⲥⲡⲉⲣⲙⲁ	sost_grec_masc_sipl
ⲥⲡⲓⲣ	sost_asso_egiz_masc_sipl
ⲥⲡⲗⲁⲅⲭⲛⲟⲛ	sost_grec_masc_sipl
ⲥⲡⲗⲁⲭⲛⲟⲛ	sost_grec_masc_sipl
ⲥⲡⲟⲛⲇⲏ	sost_asso_egiz_femm_sipl
ⲥⲡⲟⲛⲇⲓⲗⲟⲛ	sost_grec_masc_sipl
ⲥⲡⲟⲛⲧⲓⲗⲟⲛ	sost_grec_masc_sipl
ⲥⲡⲟⲧⲟⲩ	sost_asso_egiz_plur
ⲥⲡⲟⲩⲇⲏ	sost_grec_femm_sipl
ⲥⲧⲁⲥⲓⲥ	sost_grec_femm_sipl
ⲥⲧⲁⲩⲣⲟⲥ	sost_grec_masc_sipl
ⲥⲧⲉⲣⲉⲟⲙⲁ	sost_grec_masc_sipl
ⲥⲧⲉⲣⲉⲩⲙⲁ	sost_grec_masc_sipl
ⲥⲧⲉⲣⲉⲱⲙⲁ	sost_grec_masc_sipl
ⲥⲧⲏⲣⲉⲟⲙⲁ	sost_grec_masc_sipl
ⲥⲧⲏⲣⲉⲱⲙⲁ	sost_grec_masc_sipl
ⲥⲧⲟⲓ	sost_asso_egiz_masc_sipl
ⲥⲧⲟⲓⲭⲉⲓⲟⲛ	sost_grec_masc_sipl
ⲥⲧⲟⲓⲭⲓⲟⲛ	sost_grec_masc_sipl
ⲥⲧⲣⲁⲧⲉⲓⲁ	sost_grec_femm_sipl
ⲥⲧⲣⲁⲧⲉⲩⲙⲁ	sost_grec_masc_sipl
ⲥⲧⲣⲁⲧⲏⲅⲟⲥ	sost_grec_masc_sipl
ⲥⲧⲣⲁⲧⲏⲗⲁⲧⲏⲥ	sost_grec_masc_sipl
ⲥⲧⲣⲁⲧⲓⲁ	sost_grec_femm_sipl
ⲥⲧⲣⲁⲧⲟⲡⲉⲇⲁⲣⲭⲟⲥ	sost_grec_masc_sipl
ⲥⲧⲣⲁⲧⲟⲡⲉⲧⲁⲣⲭⲟⲥ	sost_grec_masc_sipl
ⲥⲧⲣⲁⲧⲩⲗⲁⲧⲏⲥ	sost_grec_masc_sipl
ⲥⲧⲣⲁⲧⲱⲣ	sost_grec_masc_sipl
ⲥⲧⲩⲗⲏ	sost_grec_femm_sipl
ⲥⲧⲩⲗⲗⲏ	sost_grec_femm_sipl
ⲥⲧⲩⲗⲗⲟⲥ	sost_grec_masc_sipl
ⲥⲧⲩⲗⲟⲥ	sost_grec_masc_sipl
ⲥⲩⲅⲅⲉⲛⲏⲥ	sost_grec_masc_sipl
ⲥⲩⲅⲕⲗⲏⲧⲟⲥ	sost_grec_femm_sipl
ⲥⲩⲙⲫⲱⲛⲓⲁ	sost_grec_femm_sipl
ⲥⲩⲛϩⲉⲇⲣⲓⲟⲛ	sost_grec_masc_sipl
ⲥⲩⲛϩⲟⲇⲟⲥ	sost_grec_femm_sipl
ⲥⲩⲛⲁⲅⲱⲅⲏ	sost_grec_femm_sipl
ⲥⲩⲛⲁⲝⲓⲥ	sost_grec_femm_sipl
ⲥⲩⲛⲅⲣⲁⲫⲉⲩⲥ	sost_grec_masc_sipl
ⲥⲩⲛⲉⲓⲇⲏⲥⲓⲥ	sost_grec_femm_sipl
ⲥⲩⲛⲍⲏⲧⲏⲧⲏⲥ	sost_grec_masc_sipl
ⲥⲩⲛⲏⲑⲓⲁ	sost_grec_femm_sipl
ⲥⲩⲛⲕⲗⲏⲣⲟⲛⲟⲙⲟⲥ	sost_grec_masc_sipl
ⲥⲩⲛⲕⲗⲏⲧⲟⲥ	sost_grec_femm_sipl
ⲥⲩⲛⲟⲩⲥⲓⲁ	sost_grec_femm_sipl
ⲥⲩⲛⲧⲁⲅⲙⲁ	sost_grec_masc_sipl
ⲥⲩⲛⲧⲁⲕⲏ	sost_grec_femm_sipl
ⲥⲩⲛⲧⲉⲗⲉⲓⲁ	sost_grec_femm_sipl
ⲥⲩⲛⲧⲉⲗⲓⲁ	sost_grec_femm_sipl
ⲥⲩⲛⲧⲉⲭⲓⲁ	sost_grec_femm_sipl
ⲥⲩⲛⲧⲏⲭⲓⲁ	sost_grec_femm_sipl
ⲥⲭⲏⲙⲁ	sost_grec_masc_sipl
ⲥⲭⲓⲍⲁ	sost_grec_femm_sipl
ⲥⲭⲓⲥⲁ	sost_grec_femm_sipl
ⲥⲭⲓⲥⲙⲁ	sost_grec_masc_sipl
ⲥⲭⲟⲗⲁⲥⲧⲓⲕⲟⲥ	sost_grec_masc_sipl
ⲥⲱϣⲉ	sost_asso_egiz_femm_sipl
ⲥⲱϩ	sost_asso_egiz_mafe_sipl
ⲥⲱⲃⲁϩ
ⲥⲱⲙⲁ	sost_grec_masc_sipl
ⲥⲱⲙⲁⲁⲩⲱ	sost_grec_masc_sipl
ⲥⲱⲙⲁⲕⲁⲓⲁⲓⲙⲁ	sost_grec_masc_sipl
ⲥⲱⲙⲁⲕⲁⲓⲁⲓⲙⲁⲭⲣⲓⲥⲧⲟⲩ	sost_grec_masc_sipl
ⲥⲱⲙⲁⲙⲛ	sost_grec_masc_sipl
ⲥⲱⲙⲁⲧⲓⲕⲏ	sost_grec_femm
ⲥⲱⲙⲁⲧⲓⲕⲟⲛ	sost_grec_masc_sipl
ⲥⲱⲛⲉ	sost_asso_egiz_femm_sipl
ⲥⲱⲧⲏⲣ	sost_grec_masc_sipl
ⲥⲱⲧⲏⲣⲓⲁ	sost_grec_femm_sipl
ⲥⲱⲫⲟⲥ	sost_grec_masc_sipl
ⲧⲁϭⲥⲉ	sost_asso_egiz_masc_sipl
ⲧⲁⲅⲙⲁ	sost_grec_masc_sipl
ⲧⲁⲓⲟⲩ	nume
ⲧⲁⲗⲁⲓⲡⲟⲣⲟⲥ	sost_grec_masc_sipl
ⲧⲁⲗⲁⲓⲡⲱⲣⲟⲥ	sost_grec_masc_sipl
ⲧⲁⲙⲉⲓⲟⲛ	sost_grec_masc_sipl
ⲧⲁⲝⲓⲥ	sost_grec_femm_sipl
ⲧⲁⲝⲓⲱⲧⲏⲥ	sost_grec_masc_sipl
ⲧⲁⲡⲣⲟ	sost_asso_egiz_femm_sipl
ⲧⲁⲣⲁⲭⲏ	sost_grec_femm_sipl
ⲧⲁⲣⲧⲁⲣⲟⲥ	sost_grec_masc_sipl
ⲧⲁⲥⲭⲓⲥⲁ	sost_grec_femm_sipl
ⲧⲁⲫⲟⲥ	sost_grec_masc_sipl
ⲧⲃⲁ	sost_asso_egiz_masc_sipl
ⲧⲃⲃⲟ	sost_verb_asso
ⲧⲃⲏⲣ	sost_asso_egiz_masc_sipl
ⲧⲃⲛⲏ	sost_asso_egiz_masc_sipl
ⲧⲃⲛⲟⲟⲩⲉ	sost_asso_egiz_plur
ⲧⲃⲧ	sost_asso_egiz_masc_sipl
ⲧⲉⲃⲧ	sost_asso_egiz_masc_sipl
ⲧⲉⲓⲙⲓⲛⲉ	sost_asso_egiz_mafe_sipl
ⲧⲉⲗϯⲗⲉ	sost_asso_egiz_masc_sipl
ⲧⲉⲗⲉⲓⲟⲥ	sost_grec_masc_sipl
ⲧⲉⲗⲟⲥ	sost_grec_masc_sipl
ⲧⲉⲗⲱⲛⲏⲥ	sost_grec_masc_sipl
ⲧⲉⲗⲱⲛⲓⲟⲛ	sost_grec_masc_sipl
#ⲧⲉⲧⲙⲟⲟⲩⲧ
ⲧⲉⲧⲣⲁⲡⲩⲗⲟⲛ	sost_grec_masc_sipl
ⲧⲉⲩⲧⲉⲣⲟⲛⲟⲙⲓⲟⲛ	sost_grec_masc_sipl
ⲧⲉⲭⲛⲏ	sost_grec_femm_sipl
ⲧⲉⲭⲛⲓⲧⲏⲥ	sost_grec_masc_sipl
ⲧⲏ	refe_dimosost_asso_egiz_masc_sipl
ⲧⲏⲃⲧ	sost_asso_egiz_masc_sipl
ⲧⲏⲏⲃⲉ	sost_asso_egiz_masc_sipl
ⲧⲏⲛϩ	sost_asso_egiz_masc_sipl
ⲧⲏⲣϥ	sost_asso_egiz_masc_sipl
ⲧⲏⲩ	sost_asso_egiz_masc_sipl
ⲧⲓⲙⲉ	sost_asso_egiz_masc_sipl
ⲧⲓⲙⲏ	sost_grec_femm_sipl
ⲧⲓⲙⲓⲛⲉ	sost_asso_egiz_mafe_sipl
ⲧⲓⲙⲟⲣⲉⲓⲁ	sost_grec_femm_sipl
ⲧⲓⲙⲟⲣⲓⲁ	sost_grec_femm_sipl
ⲧⲓⲙⲱⲣⲉⲓⲁ	sost_grec_femm_sipl
ⲧⲓⲙⲱⲣⲓⲁ	sost_grec_femm_sipl
ⲧⲓⲡⲉ	sost_asso_egiz_masc_sipl
ⲧⲓⲣⲱⲛ	sost_grec_masc_sipl
ⲧⲕⲁⲥ	sost_asso_egiz_masc_sipl
ⲧⲗϯⲗⲉ	sost_asso_egiz_masc_sipl
ⲧⲗⲧⲓⲗⲉ	sost_asso_egiz_femm_sipl
ⲧⲛϩ	sost_asso_egiz_masc_sipl
ⲧⲟ	qual
ⲧⲟϣ	sost_asso_egiz_masc_siplsost_verb_pron
ⲧⲟⲉⲓⲥ	sost_asso_egiz_femm_sipl
ⲧⲟⲉⲓⲧ	sost_verb_asso
ⲧⲟⲓⲥ	sost_asso_egiz_femm_sipl
ⲧⲟⲗⲙⲏⲣⲓⲁ	sost_grec_femm_sipl
ⲧⲟⲙⲟⲥ	sost_grec_masc_sipl
ⲧⲟⲝⲟⲧⲏⲥ	sost_grec_masc_sipl
ⲧⲟⲟⲧ	sost_asso_egiz_masc_sipl
ⲧⲟⲟⲩ	sost_asso_egiz_masc_sipl
ⲧⲟⲟⲩⲉ	sost_asso_egiz_masc_sipl
ⲧⲟⲡⲟⲥ	sost_grec_masc_sipl
ⲧⲟⲩⲉⲓⲏ	sost_asso_egiz_plur
ⲧⲟⲩⲟⲟⲧⲉ	sost_asso_egiz_plur
ⲧⲟⲩⲟⲧⲉ	sost_asso_egiz_plur
ⲧⲟⲩⲣⲏⲥ	sost_asso_egiz_masc_sipl
ⲧⲟⲩⲱⲧ	sost_asso_egiz_masc_sing
ⲧⲣⲁⲡⲉⲍⲁ	sost_grec_femm_sipl
ⲧⲣⲓⲁⲥ	sost_grec_femm_sipl
ⲧⲣⲟⲙⲟⲥ	sost_grec_masc_sipl
ⲧⲣⲟⲡⲟⲥ	sost_grec_masc_sipl
ⲧⲣⲟⲫⲏ	sost_grec_femm_sipl
ⲧⲣⲱⲫⲏ	sost_grec_femm_sipl
ⲧⲩⲡⲟⲥ	sost_grec_masc_sipl
ⲧⲩⲣⲁⲛⲛⲟⲥ	sost_grec_masc_sipl
ⲧⲱϩⲙ	sost_verb_asso
ⲧⲱⲛ	avve_egiz
ⲧⲱⲡⲟⲥ	sost_grec_masc_sipl
ⲧⲱⲧ
ⲩϣⲏ	sost_asso_egiz_femm_sipl
ⲩϣⲟⲟⲩⲉ	sost_asso_egiz_plur
ⲩϩⲟⲟⲣ	sost_asso_egiz_plur
ⲩϩⲟⲣ	sost_asso_egiz_masc_sipl
ⲩⲛⲟⲩ	sost_asso_egiz_femm_sipl
ⲩⲟⲉⲓϣ
ⲫⲁⲣⲓⲥⲁⲓⲟⲥ	sost_grec_masc_sipl
ⲫⲁⲧⲏⲣ	sost_asso_egiz_masc_sipl
ⲫⲑⲟⲛⲏⲣⲟⲥ	sost_grec_masc_sipl
ⲫⲑⲟⲛⲟⲥ	sost_grec_masc_sipl
ⲫⲓⲁⲗⲏ	sost_grec_femm_sipl
ⲫⲓⲗⲁⲣⲭⲏⲥ	sost_grec_masc_sipl
ⲫⲓⲗⲟⲕⲁⲗⲟⲥ	sost_grec_masc_sipl
ⲫⲓⲗⲟⲡⲟⲛⲓⲁ	sost_grec_femm_sipl
ⲫⲓⲗⲟⲡⲟⲛⲟⲥ	sost_grec_masc_sipl
ⲫⲓⲗⲟⲥⲟⲫⲓⲁ	sost_grec_femm_sipl
ⲫⲓⲗⲟⲥⲟⲫⲟⲥ	sost_grec_masc_sipl
ⲫⲟⲣⲟⲥ	sost_grec_masc_sipl
ⲫⲩⲗⲁⲝ	sost_grec_masc_sipl
ⲫⲩⲥⲓⲕⲏ	sost_grec_femm_sipl
ⲫⲩⲥⲓⲕⲟⲛ	sost_grec_masc_sipl
ⲫⲩⲥⲓⲥ	sost_grec_femm_sipl
ⲫⲱⲃ	sost_asso_egiz_masc_sipl
ⲫⲱⲛⲏ	sost_grec_femm_sipl
ⲫⲱⲥⲧⲏⲣ	sost_grec_masc_sipl
ⲭⲁⲗⲁⲍⲁ	sost_grec_masc_sipl
ⲭⲁⲗⲇⲁⲓⲟⲥ	sost_grec_masc_sipl
ⲭⲁⲗⲓⲛⲟⲥ	sost_grec_masc_sipl
ⲭⲁⲣⲓⲥ	sost_grec_femm_sipl
ⲭⲁⲣⲓⲥⲙⲁ	sost_grec_masc_sipl
ⲭⲁⲣⲧⲏⲥ	sost_grec_masc_sipl
ⲭⲉⲓⲙⲁⲣⲣⲟⲥ	sost_grec_masc_sipl
ⲭⲉⲓⲣⲟⲧⲟⲛⲓⲁ	sost_grec_femm_sipl
ⲭⲉⲣⲟⲩⲃⲓⲙ	sost_grec_masc_sipl
ⲭⲏⲣⲁ	sost_grec_femm_sipl
ⲭⲓⲣⲟⲇⲟⲛⲓⲁ	sost_grec_femm_sipl
ⲭⲓⲱⲛ	sost_grec_masc_sipl
ⲭⲓⲱⲛⲟⲥ	sost_grec_masc_sipl
ⲭⲟⲣⲁ
ⲭⲟⲣⲏⲅⲓⲁ	sost_grec_femm_sipl
ⲭⲟⲣⲟⲥ	sost_grec_masc_sipl
ⲭⲟⲣⲧⲟⲥ	sost_grec_masc_sipl
ⲭⲟⲩⲥ	sost_grec_masc_sipl
ⲭⲣⲉⲓⲁ	sost_grec_femm_sipl
ⲭⲣⲉⲓⲥⲧⲓⲁⲛⲟⲥ	sost_grec_masc_sipl
ⲭⲣⲏⲙⲁ	sost_grec_masc_sipl
ⲭⲣⲏⲙⲁϯⲕⲟⲛ	sost_grec_masc_sipl
ⲭⲣⲏⲙⲁⲧⲓⲕⲟⲛ	sost_grec_masc_sipl
ⲭⲣⲏⲥϯⲁⲛⲟⲥ	sost_grec_masc_sipl
ⲭⲣⲏⲥⲓⲙⲟⲛ	sost_grec_masc_sipl
ⲭⲣⲏⲥⲓⲙⲱⲛ	sost_grec_masc_sipl
ⲭⲣⲏⲥⲧⲓⲁⲛⲟⲥ	sost_grec_masc_sipl
ⲭⲣⲏⲥⲧⲟⲥ	sost_grec_masc_sipl
ⲭⲣⲓⲁ	sost_grec_femm_sipl
ⲭⲣⲓⲥϯⲁⲛⲟⲥ	sost_grec_masc_sipl
ⲭⲣⲓⲥⲧⲓⲁⲛⲟⲥ	sost_grec_masc_sipl
ⲭⲣⲓⲥⲧⲟⲥ	nome_prop_masc
ⲭⲣⲟⲛⲟⲥ	sost_grec_masc_sipl
ⲭⲣⲩⲥⲓⲥ	sost_grec_femm_sipl
ⲭⲣⲱⲙⲁ	sost_grec_masc_sipl
ⲭⲱⲣⲁ	sost_grec_femm_sipl
ⲭⲱⲣⲁⲩⲗⲏⲥ	sost_grec_masc_sipl
ⲭⲱⲣⲏⲅⲓⲁ	sost_grec_femm_sipl
ⲭⲱⲣⲏⲙⲁ	sost_grec_masc_sipl
ⲯⲁⲗⲙⲟⲥ	sost_grec_masc_sipl
ⲯⲁⲗⲙⲱⲇⲟⲥ	sost_grec_masc_sipl
ⲯⲉⲩⲇⲟⲡⲁⲣⲑⲉⲛⲟⲥ	sost_grec_femm_sipl
ⲯⲏⲫⲓⲥⲙⲁ	sost_grec_masc_sipl
ⲯⲏⲫⲟⲥ	sost_grec_masc_sipl
ⲯⲓⲥ	nume
ⲯⲓⲧⲉ	sost_asso_egiz_mafe_sipl
ⲯⲩⲫⲓⲥⲙⲁ	sost_grec_masc_sipl
ⲯⲩⲫⲟⲥ	sost_grec_masc_sipl
ⲯⲩⲭⲏ	sost_grec_femm_sipl
ⲯⲩⲭⲓⲕⲟⲛ	sost_grec_masc_sipl
ⲯⲩⲭⲟⲟⲩⲉ	sost_grec_plur
ⲱⲛϩ	sost_verb_asso
ⲱⲛⲉ	sost_asso_egiz_masc_sipl
ⲱⲛⲉⲙⲙⲉ	sost_asso_egiz_masc_sipl
ⲛⲟⲩⲧⲉ	sost_asso_egiz_masc_sipl
ϩⲉ	sost_asso_egiz_femm_siplsost_verb_asso
ⲙⲁ	sost_asso_egiz_masc_sipl
ϩⲏⲧ	sost_asso_egiz_masc_siplsost_egiz_pron
ⲣⲱⲙⲉ	sost_asso_egiz_mafe_sipl
ϫⲟⲉⲓⲥ	sost_asso_egiz_mafe_sipl
ϩⲱⲃ	sost_asso_egiz_masc_sipl
ⲗⲁⲁⲩ	sost_asso_egiz_mafe_sipl
ϣⲁϫⲉ	sost_verb_asso
ϩⲟⲟⲩ	sost_asso_egiz_masc_siplqual
ⲙⲁⲁⲩ	sost_asso_egiz_femm_sipl
ϩⲃⲏⲩⲉ	sost_asso_egiz_plur
ⲉⲓⲱⲧ	sost_asso_egiz_masc_sing
ⲕⲁⲕⲉ	sost_asso_egiz_masc_sipl
ⲟⲩⲟⲉⲓⲛ	sost_asso_egiz_masc_sipl
ⲥⲟⲛ	sost_asso_egiz_masc_sipl
ⲉⲓⲟⲧⲉ	sost_asso_egiz_plur
ϣⲏⲣⲉ	sost_asso_egiz_masc_sipl
ⲧⲟⲟⲧ	sost_asso_egiz_masc_sipl
ⲙⲉⲉⲩⲉ	sost_verb_asso
ⲩϣⲏ	sost_asso_egiz_femm_sipl
ϫⲁϫⲉ	sost_asso_egiz_mafe_sipl
ϩⲗⲗⲟ	sost_asso_egiz_masc_siplsost_asso_egiz_masc_sipl
ⲛⲟⲃⲉ	sost_asso_egiz_masc_sipl
ⲟⲩⲱϣ	sost_verb_asso
ⲥⲛⲏⲩ	sost_asso_egiz_plur
ⲡⲟⲛⲏⲣⲟⲛ	sost_grec_masc_sipl
ⲡⲟⲛⲏⲣⲟⲥ	sost_grec_masc_sipl
ⲁⲧⲥⲃⲱ	sost_asso_egiz_mafe_sipl
ⲅⲣⲁⲫⲏ	sost_grec_femm_sipl
ⲉⲛⲧⲟⲗⲏ	sost_grec_femm_sipl
ⲙⲉⲉⲣⲉ	sost_asso_egiz_mafe_sipl
ϩⲛⲁ	verb_pron
ⲛⲟϭ	sost_asso_egiz_mafe_sipl
ⲱⲛϩ	sost_verb_asso
ϩⲏⲃⲥ	sost_asso_egiz_masc_sipl
ϫⲣⲟⲡ	sost_asso_egiz_masc_sipl
ⲕⲣⲟϥ	sost_asso_egiz_masc_sipl
ⲙⲕⲁϩ	sost_verb_asso
ⲙⲏⲧⲉ	sost_asso_egiz_femm_sipl
ⲡⲟⲛⲏⲣⲓⲁ	sost_grec_femm_sipl
ⲕⲟⲟⲩⲉ	sost_asso_egiz_plur
ⲙⲉⲣⲓⲧ	sost_asso_egiz_masc_singsost_verb_pron
ⲧⲁⲡⲣⲟ	sost_asso_egiz_femm_sipl
ⲕⲟⲥⲙⲟⲥ	sost_grec_masc_sipl
ⲙⲛⲧⲥⲟϭ	sost_asso_egiz_femm_sipl
ⲛⲩⲕⲧⲉⲣⲓⲥ
ⲉⲡⲓⲥⲧⲏⲙⲏ	sost_grec_femm_sipl
ⲉⲡⲓⲥⲧⲟⲗⲏ	sost_grec_femm_sipl
ⲥⲩⲛⲁⲅⲱⲅⲏ	sost_grec_femm_sipl
ϩⲛⲟ
ⲃⲟⲗ	sost_asso_egiz_masc_siplsost_verb_pron
ⲥⲃⲱ	sost_asso_egiz_femm_sipl
ⲥⲟⲡ	sost_asso_egiz_masc_sipl
ⲧⲱⲧ
ϣⲟⲣⲡ	sost_asso_egiz_masc_sipl
ϭⲱⲛⲧ	sost_asso_egiz_masc_sipl
ⲉⲟⲟⲩ	sost_asso_egiz_masc_sipl
ⲉⲣⲏⲩ
ⲗⲁⲟⲥ	sost_grec_masc_sipl
ⲟⲩⲟⲛ	sost_asso_egiz_mafe_sipl
ϣⲉⲉⲣⲉ	sost_asso_egiz_femm_sipl
ϩⲛⲁⲁⲩ	sost_asso_egiz_masc_sipl
ϩⲟⲟⲩⲧ	sost_asso_egiz_masc_sipl
ⲥϩⲓⲙⲉ	sost_asso_egiz_femm_sing
ⲙⲛⲧⲁⲅⲁⲑⲟⲥ	sost_asso_egiz_femm_sipl
ⲁⲧϩⲏⲧ	sost_asso_egiz_mafe_sipl
ⲙⲛⲧⲁⲧⲥⲱⲧⲙ	sost_asso_egiz_femm_sipl
ⲥⲁϩⲟⲩ	sost_verb_asso
ⲡⲁⲑⲟⲥ	sost_grec_masc_sipl
ⲧⲉⲗⲱⲛⲏⲥ	sost_grec_masc_sipl
ϫⲓϫⲉⲉⲩⲉ	sost_asso_egiz_plur
ϩⲉⲑⲛⲓⲕⲟⲥ
ⲭⲁⲣⲧⲏⲥ	sost_grec_masc_sipl
ⲡⲁⲣⲑⲉⲛⲟⲥ	sost_grec_femm_sipl
ⲙⲉ	triptripsost_asso_egiz_femm_siplsost_verb_asso
ϣⲏⲙ
ϩⲧⲏ	sost_egiz_pron
ϭⲟⲗ	sost_asso_egiz_masc_sipl
ⲣⲁⲧ	sost_egiz_pron
ⲣⲡⲉ	sost_asso_egiz_masc_sipl
ϩⲏⲧⲛ
ϩⲓⲥⲉ	sost_asso_egiz_masc_sipl
ϩⲟⲩⲟ	sost_asso_egiz_masc_sipl
ϭⲟⲛⲥ	sost_asso_egiz_femm_sipl
ⲇⲓⲕⲁⲓⲟⲥ	sost_grec_masc_sipl
ⲉⲛⲉϩ	sost_asso_egiz_masc_sipl
ⲉⲥⲏⲧ
ⲡⲁϣⲉ
ⲙⲧⲟⲛ	sost_verb_asso
ⲥⲏϥⲉ	sost_asso_egiz_femm_sipl
ⲟⲩⲟⲓ	sost_asso_egiz_masc_sipl
ⲟⲩⲱⲧ	sost_asso_egiz_masc_sipl
ⲥⲁⲃⲉ	sost_asso_egiz_mafe_sipl
ⲧⲁⲙⲟ	sost_verb_assosost_verb_pron
ⲧⲃⲃⲟ	sost_verb_asso
ⲟⲩⲉⲣⲏⲧⲉ	sost_asso_egiz_plur
ϫⲓⲛϫⲏ
ϩⲉⲛⲉⲉⲧⲏ
ⲁⲅⲁⲑⲟⲥ	sost_grec_masc_sipl
ⲁⲛⲁⲅⲕⲏ	sost_grec_femm_sipl
ⲁⲛⲟⲙⲓⲁ	sost_grec_femm_sipl
ⲃⲟⲏⲑⲟⲥ	sost_grec_masc_sipl
ⲃⲁⲣⲟⲥ
ⲉⲥⲟⲟⲩ	sost_asso_egiz_masc_sipl
ⲉⲧⲉⲣⲉ	conv
ⲕⲗⲁϥⲧ	sost_asso_egiz_femm_sipl
ⲕⲟⲙⲉⲥ	sost_grec_masc_sipl
ⲗⲉⲗⲟⲩ
ⲙⲏⲏϣⲉ	sost_asso_egiz_masc_sipl
ⲥⲁϩⲛⲉ
ⲛⲁⲓⲁⲧ	verb_pron
ⲛⲟⲩϭⲥ	sost_verb_asso
ⲟⲩⲣⲟⲧ	sost_verb_asso
ⲡⲗⲏⲅⲏ	sost_grec_femm_sipl
ⲣⲁⲥⲟⲩ	sost_asso_egiz_masc_sipl
ⲥⲟⲫⲟⲥ	sost_grec_masc_sipl
ⲧⲁⲙⲟⲓ
ⲁⲡⲟⲫⲁⲥⲓⲥ	sost_grec_femm_sipl
ⲙⲛⲧⲁⲧⲛⲟⲩⲧⲉ	sost_asso_egiz_femm_sipl
ⲥⲁⲣⲕⲓⲕⲟⲛ	sost_grec_masc_sipl
ⲁⲡⲟⲥⲧⲟⲗⲟⲥ	sost_grec_masc_sipl
ⲧⲓⲙⲱⲣⲓⲁ	sost_grec_femm_sipl
ⲙⲛⲧⲣⲉϥⲧⲱϩ
ⲟⲩⲟⲉⲓϣ	sost_asso_egiz_masc_sipl
ⲡⲓⲥⲧⲟⲥ	sost_grec_masc_sipl
ⲡⲛⲉⲩⲙⲁ	sost_grec_masc_sipl
ⲣⲙⲛϩⲏⲧ	sost_asso_egiz_mafe_sipl
ⲥⲃⲟⲟⲩⲉ	sost_asso_egiz_plur
ⲥⲟⲡ[.]
ⲥⲡⲟⲧⲟⲩ	sost_asso_egiz_plur
ⲙⲛⲧⲣⲙⲛϩⲏⲧ	sost_asso_egiz_femm_sipl
ⲃⲁⲩⲕⲁⲗⲓⲟⲛ
ⲙⲛⲧⲧⲉⲗⲓⲟⲥ	sost_asso_egiz_femm_sipl
ⲃⲁⲥⲕⲁⲛⲟⲥ
ⲙⲛⲧϫⲱⲱⲣⲉ	sost_asso_egiz_femm_sipl
ⲙⲛⲧⲃⲁⲃⲉⲣⲱⲙⲉ
ⲇⲓⲁⲃⲟⲗⲟⲥ	sost_grec_masc_sipl
ⲙⲛⲧⲣⲉϥϯϭⲱⲛⲧ
ⲇⲓⲁⲕⲟⲛⲓⲁ	sost_grec_femm_sipl
ⲣⲉϥⲣⲛⲟⲃⲉ	sost_asso_egiz_mafe_sipl
ⲙⲛⲧϩⲁⲡⲗⲟⲩⲥ	sost_asso_egiz_femm_sipl
ⲁⲧⲛⲟⲩⲧⲉ	sost_asso_egiz_mafe_sipl
ⲡⲁⲣⲣⲏⲥⲓⲁ	sost_grec_femm_sipl
ⲡⲣⲟⲫⲏⲧⲏⲥ	sost_grec_masc_sipl
ϯ	refe_partrefe_dimonumesost_verb_assosost_verb_nomi
ⲛ	refe_partrefe_dimo_artinegatripconvprep_nomi_egizattrsost_verb_nomisost_verb_pron
ⲥ	refe_part
ϩⲟ	sost_asso_egiz_masc_sipl
ⲏⲓ	sost_asso_egiz_masc_sipl
ⲡⲉ	pleorefe_dimo_artirefe_dimo_pronrefe_dimo_bipnrefe_dimo_relasost_asso_egiz_femm_sipl
ⲣⲱ	cong_egizsost_egiz_pron
ⲥⲟ	nume
ⲧⲓ	refe_dimo
ⲧⲟ	qual
ϣϥⲉ
ϣⲁϩ	sost_asso_egiz_masc_siplsost_verb_asso
ϣⲟϣ	sost_asso_egiz_masc_sipl
ϩⲟϥ	sost_asso_egiz_masc_sipl
ϭⲓϫ	sost_asso_egiz_femm_sipl
ϣⲏⲓ	sost_asso_egiz_masc_sipl
ϩⲱⲥ	cong_grec
ϭⲟⲙ	sost_asso_egiz_masc_sipl
ⲁⲩⲱ	cong_egiz
ⲃⲁⲗ	sost_asso_egiz_masc_sipl
ⲏⲣⲡ	sost_asso_egiz_masc_sipl
ⲛⲉϩ	sost_asso_egiz_masc_siplsost_verb_nomi
ⲙⲁⲓ
ⲙⲟⲩ	sost_verb_asso
ⲙⲧⲟ	sost_asso_egiz_masc_sipl
ⲥⲟϭ	sost_asso_egiz_masc_sipl
ⲛⲙⲙ
ⲟⲩⲉ	sost_verb_asso
ⲣⲁⲛ	sost_asso_egiz_masc_sipl
ⲣⲙⲏ
ⲱⲣϫ	sost_verb_asso
ⲧⲱⲛ	avve_egiz
ϫⲱϩⲙ	sost_verb_asso
ϣⲓⲛⲉ	sost_verb_asso
ϣⲙⲙⲟ	sost_asso_egiz_mafe_sipl
ϣⲟⲟⲩ
ϩⲁⲁⲩ
ϩⲟⲩo
ϩⲗⲗⲱ	sost_asso_egiz_femm_sipl
ϩⲟⲧⲉ	sost_asso_egiz_femm_sipl
ϩⲟⲩⲛ	sost_asso_egiz_masc_sipl
ϫⲁⲓⲉ	sost_asso_egiz_masc_sipl
ϯⲧⲱⲛ	sost_asso_egiz_masc_sipl
ⲭⲣⲓⲥⲧⲟⲥ	nome_prop_masc
ⲥⲕⲉⲡⲁⲥⲧⲏⲥ
ⲇⲓⲕⲁⲓⲟⲛ	sost_grec_masc_sipl
ⲁⲑⲏⲧ	sost_asso_egiz_mafe_sipl
ⲁⲓⲱⲛ	sost_grec_masc_sipl
ⲃⲗⲗⲉ	sost_asso_egiz_mafe_sipl
ⲃⲗⲗⲏ
ⲙⲡϣⲁ	sost_verb_asso
ⲙⲓⲛⲉ	sost_asso_egiz_femm_sipl
ⲥⲁϣϥ	nume
ⲙⲟⲩⲥ
ⲥⲓϣⲉ	sost_asso_egiz_masc_sipl
ⲟⲛⲧⲉ
ⲟⲩⲉϣ	sost_verb_nomi
ⲟⲣⲅⲏ	sost_grec_femm_sipl
ⲟⲩⲱⲙ	sost_verb_asso
ⲡⲏⲅⲏ	sost_grec_femm_sipl
ⲡⲣⲏϣ
ⲥⲁⲣⲝ	sost_grec_femm_sipl
ⲥⲛⲟϥ	sost_asso_egiz_masc_sipl
ⲥⲙⲙⲉ	sost_verb_asso
ⲥⲙⲟⲧ	sost_asso_egiz_masc_sipl
ⲥⲱⲙⲁ	sost_grec_masc_sipl
ⲉⲗⲁⲭⲓⲥⲧⲟⲛ	sost_grec_masc_sipl
ⲯⲩⲭⲏ	sost_grec_femm_sipl
ⲙⲛⲧⲣⲉϥϩⲓⲗⲁ
ⲙⲛⲧⲁⲧⲥⲃⲱ	sost_asso_egiz_femm_sipl
ⲙⲛⲧⲛⲟⲩⲧⲉ	sost_asso_egiz_femm_sipl
ⲙⲛⲧⲥⲧⲙⲏⲧ	sost_asso_egiz_femm_sipl
ϣⲟⲩϣⲟⲩ	sost_verb_asso
ⲕⲟⲓⲛⲱⲛⲟⲥ	sost_grec_masc_sipl
ϩⲟⲉⲓⲧⲉ	sost_asso_egiz_masc_sipl
ⲟⲓⲕⲟⲩⲙⲉⲛⲏ	sost_grec_masc_sipl
ⲥⲧⲉⲣⲉⲱⲙⲁ	sost_grec_masc_sipl
ⲙⲛⲧⲣⲉϥϩⲉⲧⲃⲯⲩⲭⲏ
ϣⲟϫⲛⲉ	sost_asso_egiz_masc_sipl
ϩⲏⲏⲛⲉ
ϩⲓⲟⲛⲉ
ϩⲗⲗⲟⲓ
ϩⲟⲟⲗⲉ
ϩⲟⲥⲟⲛ
ϫⲓⲟⲩⲉ	sost_verb_asso
ϭⲗⲱⲡⲉ
ⲡⲁⲣⲁⲇⲉⲓⲥⲟⲥ	sost_grec_masc_sipl
ⲡⲁⲛⲟⲩⲣⲅⲓⲁ
ⲙⲛⲧϫⲁⲥⲓϩⲏⲧ	sost_asso_egiz_femm_sipl
ⲥⲕⲁⲛⲇⲁⲗⲟⲛ	sost_grec_masc_sipl
ϩⲩⲡⲟⲧⲁⲅⲏ	sost_grec_femm_sipl
ⲙⲉⲥⲟⲩⲁⲫⲓ
ⲣϩⲙⲙⲉ	sost_verb_asso
ⲁⲅⲁⲑⲟⲛ	sost_grec_masc_sipl
ⲁⲅⲅⲓⲟⲛ
ⲃⲟⲏⲑⲓⲁ
ⲁⲛ	nega
ⲛ	refe_partrefe_dimo_artinegatripconvprep_nomi_egizattrsost_verb_nomisost_verb_pron
ⲧⲙ	refe_partnega
ϣⲉⲛⲟⲩⲧⲉ	nome_prop_masc
ϣⲓⲏⲧ	nome_prop_masc
ϩⲁϭⲉ	nome_prop_masc
ϩⲁⲙⲱⲥ
ϩⲉⲣⲙⲏⲥ	nome_prop_masc
ϩⲉⲣⲙⲟⲅⲉⲛⲏⲥ	nome_prop_masc
ϩⲏⲗⲉⲓ	nome_prop_masc
ϩⲏⲗⲉⲓⲁⲥ	nome_prop_masc
ϩⲏⲗⲓ	nome_prop_masc
ϩⲏⲗⲓⲁⲥ	nome_prop_masc
ϩⲏⲗⲓⲟⲇⲱⲣⲟⲥ	nome_prop_masc
ϩⲏⲗⲗⲏⲛ	nome_prop_masc
ϩⲏⲙⲉⲛⲁⲓⲟⲥ	nome_prop_masc
ϩⲏⲣⲟⲇⲏⲥ	nome_prop_masc
ϩⲏⲣⲱⲇⲏⲥ	nome_prop_masc
ϩⲓⲉⲣⲟⲥⲟⲗⲩⲙⲁ
ϩⲓⲉⲣⲟⲩⲥⲁⲗⲏⲙ	nome_prop_masc
ϩⲟⲥⲉⲙ	nome_prop_masc
ϩⲣⲟⲃⲟⲁⲙ
ϩⲣⲱⲙⲁⲛⲟⲥ	nome_prop_masc
ϩⲣⲱⲙⲏ	nome_prop_femm
ϩⲩⲙⲉⲛⲁⲓⲟⲥ	nome_prop_masc
ϩⲩⲡⲉⲣⲓⲭⲟⲥ	nome_prop_masc
ϩⲱⲣⲓⲅⲉⲛⲏⲥ	nome_prop_masc
ϩⲱⲣⲥⲓⲉⲥⲓⲟⲥ	nome_prop_masc
ϩⲱⲣⲥⲓⲏⲥⲓⲟⲥ	nome_prop_masc
ⲁⲁⲣⲱⲛ	nome_prop_masc
ⲁⲃⲁⲅⲟⲩⲙ	nome_prop_masc
ⲁⲃⲁⲕⲟⲩⲙ	nome_prop_masc
ⲁⲃⲉⲛⲛⲏⲣ	nome_prop_masc
ⲁⲃⲓⲁ
ⲁⲃⲓⲁⲥ
ⲁⲃⲓⲙⲉⲗⲉⲭ	nome_prop_masc
ⲁⲃⲓⲟⲩⲇ
ⲁⲃⲓⲣⲱⲛ	nome_prop_masc
ⲁⲃⲓⲥⲁⲗⲱⲙ	nome_prop_masc
ⲁⲃⲣⲁϩⲁⲙ	nome_prop_masc
ⲁⲅⲁⲅⲓⲟⲥ	nome_prop_masc
ⲁⲅⲁⲑⲟⲛⲓⲕⲟⲥ	nome_prop_masc
ⲁⲅⲁⲑⲱⲛⲓⲕⲟⲥ	nome_prop_masc
ⲁⲅⲁⲕⲓⲟⲥ	nome_prop_masc
ⲁⲅⲕⲩⲣⲁ	nome_prop_femm
ⲁⲅⲣⲓⲡⲡⲁⲥ	nome_prop_masc
ⲁⲇⲁⲙ	nome_prop_masc
ⲁⲍⲱⲣⲁ
ⲁⲍⲱⲣⲁⲥ
ⲁⲑⲁⲛⲁⲥⲓⲟⲥ	nome_prop_masc
ⲁⲑⲱⲣ	nome_prop_masc
ⲁⲕⲁⲅⲓⲟⲥ	nome_prop_masc
ⲁⲕⲁⲕⲓⲟⲥ	nome_prop_masc
ⲁⲕⲉⲗⲇⲁⲙⲁⲭ	nome_prop_masc
ⲁⲕⲉⲗⲧⲁⲙⲁⲭ	nome_prop_masc
ⲁⲗⲉⲝⲁⲛⲇⲣⲟⲥ	nome_prop_masc
ⲁⲙⲓⲛⲁⲇⲁⲃ
ⲁⲙⲙⲱⲧⲓⲟⲛ	nome_prop_masc
ⲁⲙⲱⲛⲁ
ⲁⲛϯⲛⲱⲟⲩ	nome_prop_femm
ⲁⲛⲁⲧⲟⲗⲏ	nome_prop_femm
ⲁⲛⲁⲧⲟⲗⲓⲟⲥ	nome_prop_masc
ⲁⲛⲇⲣⲉⲁⲥ	nome_prop_masc
ⲁⲛⲑⲓⲙⲟⲥ	nome_prop_masc
ⲁⲛⲧⲓⲛⲟⲟⲩ	nome_prop_masc
ⲁⲛⲧⲓⲟⲭⲓⲁ	nome_prop_masc
ⲁⲛⲧⲱⲛⲓⲟⲥ	nome_prop_masc
ⲁⲡϩⲟⲩ	nome_prop_masc
ⲁⲡⲟⲗⲗⲟⲛ	nome_prop_masc
ⲁⲡⲟⲗⲗⲱ	nome_prop_masc
ⲁⲡⲟⲗⲗⲱⲛ	nome_prop_masc
ⲁⲡⲱⲗⲗⲟⲛ	nome_prop_masc
ⲁⲡⲱⲗⲗⲱ	nome_prop_masc
ⲁⲡⲱⲗⲗⲱⲛ	nome_prop_masc
ⲁⲣⲁⲙ
ⲁⲣⲓⲟⲥ	nome_prop_masc
ⲁⲣⲓⲥⲧⲟⲇⲉⲗⲏⲥ	nome_prop_masc
ⲁⲣⲓⲥⲧⲟⲧⲉⲗⲏⲥ	nome_prop_masc
ⲁⲣⲓⲫⲟⲣⲟⲥ	nome_prop_masc
ⲁⲣⲕⲁⲇⲓⲟⲥ	nome_prop_masc
ⲁⲣⲥⲉⲛⲓⲟⲥ	nome_prop_masc
ⲁⲣⲥⲩⲛⲓⲟⲥ	nome_prop_masc
ⲁⲣⲭⲏⲗⲁⲟⲥ	nome_prop_masc
ⲁⲣⲱⲛ	nome_prop_masc
ⲁⲥⲁⲫ
ⲁⲥⲉⲛⲛⲉⲑ	nome_prop_masc
ⲁⲩⲗⲏⲣⲓⲁⲛⲟⲥ	nome_prop_masc
ⲁⲫⲟⲩ	nome_prop_masc
ⲁⲭⲁⲁⲃ	nome_prop_masc
ⲁⲭⲁⲃ	nome_prop_masc
ⲁⲭⲉⲓⲙ
ⲁⲭⲉⲣⲟⲩⲥⲓⲁ	nome_prop_masc
ⲁⲭⲓⲗⲗⲁⲥ	nome_prop_masc
ⲁⲭⲓⲧⲱⲃⲉⲗ	nome_prop_masc
ⲃⲁϩⲁⲗ	nome_prop_masc
ⲃⲁⲃⲩⲗⲱⲛ
ⲃⲁⲣⲕⲁⲃⲁⲛ	nome_prop_masc
ⲃⲁⲣⲕⲱⲃ	nome_prop_masc
ⲃⲁⲥⲓⲗⲉⲓⲟⲥ	nome_prop_masc
ⲃⲁⲥⲓⲗⲓⲟⲥ	nome_prop_masc
ⲃⲁⲥⲓⲗⲓⲥⲕⲟⲥ	nome_prop_masc
ⲃⲁⲥⲓⲗⲓⲧⲏⲥ	nome_prop_masc
ⲃⲉⲍⲁⲛⲧⲓⲟⲛ	nome_prop_masc
ⲃⲉⲥⲁⲛⲧⲓⲟⲛ	nome_prop_masc
ⲃⲏϭ	nome_prop_masc
ⲃⲓⲕⲧⲱⲣ	nome_prop_masc
ⲃⲟⲉⲥ
ⲃⲩⲍⲁⲛⲧⲓⲟⲛ	nome_prop_masc
ⲃⲩⲥⲁⲛⲧⲓⲟⲛ	nome_prop_masc
ⲅⲁⲃⲣⲓⲏⲗ	nome_prop_masc
ⲅⲁⲓⲟⲥ	nome_prop_masc
ⲅⲁⲗⲁⲧⲓⲁ	nome_prop_femm
ⲅⲁⲗⲉⲓⲗⲁⲓⲁ	nome_prop_femm
ⲅⲁⲗⲓⲗⲁⲓⲁ	nome_prop_femm
ⲅⲉⲇⲉⲱⲛ	nome_prop_masc
ⲅⲉⲱⲣⲅⲓⲟⲥ	nome_prop_masc
ⲅⲟⲙⲟⲣⲣⲁ	nome_prop_masc
ⲅⲣⲏⲅⲟⲣⲓⲟⲥ	nome_prop_masc
ⲇⲁⲑⲁⲛ	nome_prop_masc
ⲇⲁⲙⲁⲥⲕⲟⲥ	nome_prop_masc
ⲇⲁⲛⲓⲏⲗ	nome_prop_masc
ⲇⲁⲩⲉⲓⲇ	nome_prop_masc
ⲇⲁⲩⲓⲇ	nome_prop_masc
ⲇⲉⲕⲓⲟⲥ	nome_prop_masc
ⲇⲏⲙⲁⲥ	nome_prop_masc
ⲇⲏⲙⲏⲧⲣⲓⲟⲥ	nome_prop_masc
ⲇⲓⲁⲃⲟⲗⲟⲥ	sost_grec_masc_sipl
ⲇⲓⲙⲏⲧⲣⲓⲟⲥ	nome_prop_masc
ⲇⲓⲙⲟⲑⲉⲟⲥ	nome_prop_masc
ⲇⲓⲟⲕⲗⲏⲧⲓⲁⲛⲟⲥ	nome_prop_masc
ⲇⲓⲟⲛⲏⲥⲓⲟⲥ	nome_prop_masc
ⲇⲓⲟⲛⲩⲥⲓⲟⲥ	nome_prop_masc
ⲇⲓⲟⲥⲕⲟⲣⲟⲥ	nome_prop_masc
ⲇⲟⲙⲛⲟⲥ	nome_prop_masc
ⲇⲩⲣⲁⲛⲟⲥ	nome_prop_masc
ⲇⲱⲣⲟⲑⲉⲟⲥ	nome_prop_masc
ⲉϭⲟⲟϣ	nome_prop_masc
ⲉⲍⲉⲅⲓⲏⲗ	nome_prop_masc
ⲉⲍⲉⲕⲉⲓⲁⲥ
ⲉⲍⲉⲕⲓⲁⲥ	nome_prop_masc
ⲉⲍⲉⲕⲓⲏⲗ	nome_prop_masc
ⲉⲓⲉⲣⲉⲛⲛⲁⲓⲟⲥ	nome_prop_masc
ⲉⲓⲥⲧⲟⲛⲥⲧⲁⲩⲣⲟⲛ	nome_prop_masc
ⲉⲗⲁⲣⲓⲭⲟⲥ	nome_prop_masc
ⲉⲗⲉⲁⲍⲁⲣ
ⲉⲗⲉⲥⲁⲓⲟⲥ	nome_prop_masc
ⲉⲗⲓⲁⲃ	nome_prop_masc
ⲉⲗⲓⲁⲕⲓⲙ
ⲉⲗⲓⲟⲩⲇ
ⲉⲗⲓⲥⲁⲓⲟⲥ	nome_prop_masc
ⲉⲗⲓⲥⲥⲁⲓⲟⲥ	nome_prop_masc
ⲉⲗⲩⲥⲁⲓⲟⲥ	nome_prop_masc
ⲉⲛⲕⲣⲁⲧⲱⲣ	nome_prop_masc
ⲉⲛⲱⲭ	nome_prop_masc
ⲉⲡⲏⲡ	nome_prop_masc
ⲉⲡⲓⲡ	nome_prop_masc
ⲉⲥⲓⲇⲟⲣⲟⲥ	nome_prop_masc
ⲉⲥⲣⲱⲙ
ⲉⲩⲁⲅⲣⲓⲟⲥ	nome_prop_masc
ⲉⲩⲛⲟⲙⲟⲥ	nome_prop_masc
ⲉⲩⲥⲉⲃⲓⲟⲥ	nome_prop_masc
ⲉⲩⲥⲧⲁⲑⲓⲁⲛⲟⲥ	nome_prop_masc
ⲉⲩⲥⲧⲁⲑⲓⲟⲥ	nome_prop_masc
ⲉⲩⲥⲧⲟⲭⲓⲟⲥ	nome_prop_masc
ⲉⲩⲧⲏⲭⲓⲁⲛⲟⲥ	nome_prop_masc
ⲉⲩⲧⲣⲟⲡⲓⲟⲥ	nome_prop_masc
ⲉⲩⲧⲩⲭⲏⲥ	nome_prop_masc
ⲉⲩⲫⲏⲙⲓⲁ	nome_prop_femm
ⲉⲫⲉⲥⲟⲥ	nome_prop_masc
ⲍⲁⲃⲟⲩⲗⲟⲛ	nome_prop_masc
ⲍⲁⲭⲁⲓⲟⲥ	nome_prop_masc
ⲍⲁⲭⲁⲣⲓⲁⲥ	nome_prop_masc
ⲍⲉⲇⲉⲕⲓⲁⲥ	nome_prop_masc
ⲍⲉⲩⲥ	nome_prop_masc
ⲍⲏⲛⲱⲛ	nome_prop_masc
ⲍⲟⲣⲟⲃⲁⲃⲉⲗ
ⲍⲱⲕⲣⲁⲧⲱⲥ	nome_prop_masc
ⲏⲗⲓⲥⲥⲁⲓⲟⲥ	nome_prop_masc
ⲏⲥⲁⲓⲁⲥ	nome_prop_masc
ⲑⲁⲣⲙⲉⲛⲓⲁ	nome_prop_femm
ⲑⲁⲣⲙⲏⲛⲓⲁ	nome_prop_femm
ⲑⲉⲃⲁⲥⲓⲁ	nome_prop_masc
ⲑⲉⲟⲇⲟⲣⲓⲭⲟⲥ	nome_prop_masc
ⲑⲉⲟⲇⲟⲥⲓⲟⲥ	nome_prop_masc
ⲑⲉⲟⲇⲟⲣⲟⲥ
ⲑⲉⲟⲇⲱⲣⲟⲥ	nome_prop_masc
ⲑⲉⲟⲇⲱⲥⲓⲟⲥ	nome_prop_masc
ⲑⲉⲟⲫⲓⲗⲟⲥ	nome_prop_masc
ⲑⲉⲟⲫⲩⲗⲟⲥ	nome_prop_masc
ⲑⲉⲱⲇⲟⲥⲓⲟⲥ	nome_prop_masc
ⲑⲉⲱⲇⲱⲣⲟⲥ	nome_prop_masc
ⲑⲉⲱⲇⲱⲥⲓⲟⲥ	nome_prop_masc
ⲑⲉⲱⲫⲓⲗⲟⲥ	nome_prop_masc
ⲑⲏⲃⲁⲉⲓⲥ	nome_prop_femm
ⲑⲏⲃⲁⲓⲥ	nome_prop_femm
ⲑⲏⲥⲁⲩⲣⲓⲁ	nome_prop_femm
ⲑⲓⲉⲣⲟⲩⲥⲁⲗⲏⲙ	nome_prop_masc
ⲑⲓⲥⲁⲩⲣⲓⲁ	nome_prop_femm
ⲑⲙⲟⲩⲓ	nome_prop_masc
ⲑⲟⲟⲩⲧ	nome_prop_masc
ⲑⲣⲁⲝ	nome_prop_femm
ⲓⲁⲕⲟⲃⲟⲥ	nome_prop_masc
ⲓⲁⲕⲱⲃ	nome_prop_masc
ⲓⲁⲕⲱⲃⲟⲥ	nome_prop_masc
ⲓⲁⲙⲃⲣⲏⲥ	nome_prop_masc
ⲓⲁⲛⲛϩⲥ	nome_prop_masc
ⲓⲁⲛⲛⲏⲥ	nome_prop_masc
ⲓⲉⲍⲁ	nome_prop_masc
ⲓⲉⲣⲉⲙⲓⲁ	nome_prop_masc
ⲓⲉⲣⲉⲙⲓⲁⲥ	nome_prop_masc
ⲓⲉⲣⲏⲙⲓⲁⲥ	nome_prop_masc
ⲓⲉⲣⲏⲛⲛⲁⲓⲟⲥ	nome_prop_masc
ⲓⲉⲥⲥⲁⲓ	nome_prop_masc
ⲓⲉⲭⲟⲛⲓⲁⲥ
ⲓⲏⲥⲟⲩⲥ	nome_prop_masc
ⲓⲛⲇⲓⲁ	nome_prop_masc
ⲓⲟⲃⲉⲛⲛⲁⲗⲓⲟⲥ	nome_prop_masc
ⲓⲟⲃⲓⲁⲛⲟⲥ	nome_prop_masc
ⲓⲟⲣⲇⲁⲛⲏⲥ	nome_prop_masc
ⲓⲟⲩ	nome_prop_masc
ⲓⲟⲩⲃⲉⲛⲁⲗⲓⲟⲥ	nome_prop_masc
ⲓⲟⲩⲃⲉⲛⲛⲁⲗⲓⲟⲥ	nome_prop_masc
ⲓⲟⲩⲃⲓⲁⲛⲟⲥ	nome_prop_masc
ⲓⲟⲩⲇⲁ
ⲓⲟⲩⲇⲁⲥ	nome_prop_masc
ⲓⲟⲩⲗⲓⲁⲛⲟⲥ	nome_prop_masc
ⲓⲟⲩⲗⲓⲟⲥ	nome_prop_masc
ⲓⲟⲩⲥϯⲛⲟⲥ	nome_prop_masc
ⲓⲟⲩⲥⲧⲓⲛⲟⲥ	nome_prop_masc
ⲓⲥⲁⲁⲕ	nome_prop_masc
ⲓⲥⲓⲇⲱⲣⲟⲥ	nome_prop_masc
ⲓⲥⲣⲁⲏⲗ	nome_prop_masc
ⲓⲱϩⲁⲛⲛⲏⲥ	nome_prop_masc
ⲓⲱⲁⲑⲁⲙ
ⲓⲱⲃ	nome_prop_masc
ⲓⲱⲃⲏⲇ
ⲓⲱⲛⲁⲑⲁⲙ
ⲓⲱⲣⲁⲙ
ⲓⲱⲥⲁⲫⲁⲧ
ⲓⲱⲥⲏⲡⲡⲟⲥ	nome_prop_masc
ⲓⲱⲥⲏⲫ	nome_prop_masc
ⲓⲱⲥⲓⲁⲥ
ⲕⲁⲉⲓⲛ	nome_prop_masc
ⲕⲁⲓⲛ	nome_prop_masc
ⲕⲁⲓⲥⲁⲣⲉⲓⲁ	nome_prop_femm
ⲕⲁⲓⲥⲁⲣⲓⲁ	nome_prop_femm
ⲕⲁⲓⲥⲁⲣⲓⲟⲥ	nome_prop_masc
ⲕⲁⲓⲫⲁⲥ	nome_prop_masc
ⲕⲁⲗⲗⲓⲡⲁ	nome_prop_femm
ⲕⲁⲛⲇⲁⲕⲏ	nome_prop_femm
ⲕⲁⲛⲇⲓⲇⲓⲁⲛⲟⲥ	nome_prop_masc
ⲕⲁⲛⲇⲓⲧⲓⲁⲛⲟⲥ	nome_prop_masc
ⲕⲁⲛⲟⲡⲟⲥ	nome_prop_masc
ⲕⲁⲡⲡⲁⲇⲟⲕⲓⲁ	nome_prop_femm
ⲕⲁⲣⲓⲛⲟⲥ	nome_prop_masc
ⲕⲁⲣⲙⲏⲗⲟⲥ	nome_prop_masc
ⲕⲁⲣⲟⲥ	nome_prop_masc
ⲕⲁⲣⲡⲱⲕⲣⲁⲧⲱⲣ	nome_prop_masc
ⲕⲁⲣⲭⲏⲇⲱⲛ	nome_prop_masc
ⲕⲁⲥⲧⲱⲣ	nome_prop_masc
ⲕⲁⲧⲁⲓⲱϩⲁⲛⲛⲏⲥ	nome_prop_masc
ⲕⲁⲧⲁⲗⲟⲩⲕⲁⲥ	nome_prop_masc
ⲕⲁⲧⲁⲙⲁⲑⲑⲁⲓⲟⲥ	nome_prop_masc
ⲕⲁⲧⲁⲙⲁⲣⲕⲟⲥ	nome_prop_masc
ⲕⲁⲧⲁⲙⲁⲧⲑⲁⲓⲟⲥ	nome_prop_masc
ⲕⲁⲫⲁⲣⲛⲁⲟⲩⲙ	nome_prop_masc
ⲕⲉⲗⲉⲥϯⲛⲟⲥ	nome_prop_masc
ⲕⲉⲥⲁⲣⲉⲓⲁ	nome_prop_femm
ⲕⲉⲥⲁⲣⲓⲁ	nome_prop_femm
ⲕⲏⲙⲉ	nome_prop_masc
ⲕⲗⲁⲩⲇⲓⲟⲥ	nome_prop_masc
ⲕⲟⲉⲓⲥ	nome_prop_masc
ⲕⲟⲛⲱⲛ	nome_prop_masc
ⲕⲟⲥⲧⲁⲛⲧⲓⲛⲟⲥ	nome_prop_masc
ⲕⲟⲥⲧⲁⲥ	nome_prop_masc
ⲕⲟⲩⲓⲛⲉⲣⲱⲧ	nome_prop_femm
ⲕⲩⲛⲏⲅⲟⲥ	nome_prop_masc
ⲕⲩⲣⲓⲗⲗⲟⲥ	nome_prop_masc
ⲕⲱⲛⲟⲛ	nome_prop_masc
ⲕⲱⲥ	nome_prop_masc
ⲕⲱⲥⲧⲁⲛϯⲛⲟⲥ	nome_prop_masc
ⲕⲱⲥⲧⲁⲛϯⲟⲥ	nome_prop_masc
ⲕⲱⲥⲧⲁⲛⲧⲓⲛⲟⲥ	nome_prop_masc
ⲕⲱⲥⲧⲁⲛⲧⲓⲛⲟⲩⲡⲟⲗⲉⲓⲥ	nome_prop_masc
ⲕⲱⲥⲧⲁⲛⲧⲓⲛⲟⲩⲡⲟⲗⲓⲥ	nome_prop_masc
ⲕⲱⲥⲧⲁⲛⲧⲓⲟⲥ	nome_prop_masc
ⲕⲱⲥⲧⲁⲥ	nome_prop_masc
ⲕⲱⲥⲧⲟⲥ	nome_prop_masc
ⲗⲁⲃⲁⲛ	nome_prop_masc
ⲗⲁⲍⲁⲣⲟⲥ	nome_prop_masc
ⲗⲁⲟⲇⲓⲕⲓⲁ	nome_prop_masc
ⲗⲉⲡⲧⲟⲇⲏⲙⲟⲥ	nome_prop_masc
ⲗⲉⲡⲧⲟⲇⲩⲙⲟⲥ	nome_prop_masc
ⲗⲉⲱⲛ	nome_prop_masc
ⲗⲓⲃⲁⲛⲟⲥ	nome_prop_masc
ⲗⲓⲃⲉⲣⲓⲟⲥ	nome_prop_masc
ⲗⲟⲩⲕⲁⲥ	nome_prop_masc
ⲗⲟⲩⲕⲓⲟⲥ	nome_prop_masc
ⲗⲱⲧ	nome_prop_masc
ⲙⲁⲅⲇⲁⲗⲓⲁ	nome_prop_masc
ⲙⲁⲅⲇⲁⲗⲓⲛⲏ	nome_prop_masc
ⲙⲁⲕⲇⲁⲗⲓⲁ	nome_prop_masc
ⲙⲁⲗⲁⲭⲓⲁⲥ	nome_prop_masc
ⲙⲁⲛⲁⲥⲥⲉ	nome_prop_masc
ⲙⲁⲛⲁⲥⲥⲏ
ⲙⲁⲛⲏ	nome_prop_masc
ⲙⲁⲛⲥⲁⲕⲏⲧⲏⲥ	nome_prop_masc
ⲙⲁⲛⲥⲓⲕⲏⲧⲏⲥ	nome_prop_masc
ⲙⲁⲣⲇⲟⲭⲁⲓⲟⲥ	nome_prop_masc
ⲙⲁⲣⲏⲥ	nome_prop_masc
ⲙⲁⲣⲑⲁ	nome_prop_masc
ⲙⲁⲣⲓϩⲁⲙ	nome_prop_femm
ⲙⲁⲣⲓⲁ	nome_prop_femm
ⲙⲁⲣⲓⲛⲟⲥ	nome_prop_masc
ⲙⲁⲣⲓⲥ	nome_prop_masc
ⲙⲁⲣⲕⲉⲗⲗⲓⲁⲛⲟⲥ	nome_prop_masc
ⲙⲁⲣⲕⲓⲁⲛⲟⲥ	nome_prop_masc
ⲙⲁⲣⲕⲟⲥ	nome_prop_masc
ⲙⲁⲣⲕⲩⲁⲛⲟⲥ	nome_prop_masc
ⲙⲁⲥⲅⲝ	nome_prop_masc
ⲙⲁⲧⲑⲁⲙ
ⲙⲉⲗⲓⲧⲓⲟⲥ	nome_prop_masc
ⲙⲉⲗⲭⲓⲥⲉⲇⲉⲕ	nome_prop_masc
ⲙⲉⲛⲁⲛⲇⲣⲟⲥ	nome_prop_masc
ⲙⲉⲣⲕⲟⲩⲣⲓⲟⲥ	nome_prop_masc
ⲙⲉⲣⲟⲉⲓⲧ	nome_prop_masc
ⲙⲓⲭⲁⲏⲗ	nome_prop_masc
ⲙⲓⲭⲁⲓⲁⲥ	nome_prop_masc
ⲙⲱⲩⲥⲏⲥ	nome_prop_masc
ⲛⲁⲁⲥⲥⲱⲛ
ⲛⲁⲃⲟⲩⲭⲟⲇⲟⲛⲟⲥⲟⲣ	nome_prop_masc
ⲛⲁⲍⲁⲣⲉⲑ	nome_prop_masc
ⲛⲁⲓⲙⲁⲛ	nome_prop_masc
ⲛⲉⲁⲡⲟⲗⲉⲓⲥ	nome_prop_femm
ⲛⲉⲁⲡⲟⲗⲓⲥ	nome_prop_femm
ⲛⲉⲟⲕⲁⲓⲥⲁⲣⲉⲓⲁ	nome_prop_femm
ⲛⲉⲥⲧⲟⲣⲓⲟⲥ	nome_prop_masc
ⲛⲉⲥⲧⲱⲣⲓⲟⲥ	nome_prop_masc
ⲛⲉⲫⲑⲁⲗⲉⲓⲙ	nome_prop_masc
ⲛⲓϣϭⲣⲱⲟⲩ	nome_prop_masc
ⲛⲓⲕⲁⲓⲁ	nome_prop_masc
ⲛⲓⲕⲟⲙⲏⲇⲏⲥ	nome_prop_masc
ⲛⲓⲕⲟⲙⲏⲧⲏⲥ	nome_prop_masc
ⲛⲓⲧⲣⲓⲁ	nome_prop_masc
ⲛⲟⲏ	nome_prop_femm
ⲛⲟⲩⲙⲉⲣⲓⲁⲛⲟⲥ	nome_prop_masc
ⲛⲱϩⲉ	nome_prop_masc
ⲟⲍⲉⲓⲁⲥ
ⲟⲗⲃⲓⲟⲥ	nome_prop_masc
ⲟⲛⲛⲟⲣⲓⲟⲥ	nome_prop_masc
ⲟⲛⲛⲱⲣⲓⲟⲥ	nome_prop_masc
ⲟⲛⲟⲣⲓⲟⲥ	nome_prop_masc
ⲟⲛⲱⲣⲓⲟⲥ	nome_prop_masc
ⲟⲩⲁⲗⲉⲛⲧⲓⲛⲟⲥ	nome_prop_masc
ⲟⲩⲁⲗⲏⲥ	nome_prop_masc
ⲟⲩⲉⲥⲡⲁⲥⲓⲁⲛⲟⲥ	nome_prop_masc
ⲟⲩⲣⲃⲁⲧⲟⲥ	nome_prop_masc
ⲟⲩⲣⲓⲁⲥ	nome_prop_masc
ⲡϣϭⲉⲡⲟϩⲉ	nome_prop_masc
ⲡϣⲟⲓ	nome_prop_masc
ⲡⲁϣⲟⲛⲥ	nome_prop_masc
ⲡⲁϩⲟⲙⲱ	nome_prop_masc
ⲡⲁϩⲱⲙ	nome_prop_masc
ⲡⲁϩⲱⲙⲟ	nome_prop_masc
ⲡⲁϩⲱⲙⲱ	nome_prop_masc
ⲡⲁⲏⲥⲉ	nome_prop_masc
ⲡⲁⲗⲁⲧⲓⲛⲟⲥ	nome_prop_masc
ⲡⲁⲗⲓⲥϯⲛⲏ	nome_prop_masc
ⲡⲁⲗⲗⲁⲧⲓⲛⲟⲥ	nome_prop_masc
ⲡⲁⲙⲟⲩⲛ	nome_prop_masc
ⲡⲁⲛⲟⲥ	nome_prop_femm
ⲡⲁⲡⲛⲟⲩⲧⲉ	nome_prop_masc
ⲡⲁⲡⲟϩⲉ	nome_prop_masc
ⲡⲁⲣⲉⲙϩⲟⲧⲡ	nome_prop_masc
ⲡⲁⲣⲙϩⲟⲧⲡ	nome_prop_masc
ⲡⲁⲣⲙⲟⲩⲧⲉ	nome_prop_masc
ⲡⲁⲥⲭⲱⲣ	nome_prop_masc
ⲡⲁⲩⲗⲉ	nome_prop_masc
ⲡⲁⲩⲗⲟⲥ	nome_prop_masc
ⲡⲁⲱⲛⲉ	nome_prop_masc
ⲡⲃⲁⲩ	nome_prop_masc
ⲡⲉⲑⲁⲅⲟⲣⲁ	nome_prop_masc
ⲡⲉⲑⲁⲅⲟⲣⲁⲥ	nome_prop_masc
ⲡⲉⲙϫⲉ	nome_prop_masc
ⲡⲉⲣⲥⲓⲥ	nome_prop_femm
ⲡⲉⲣⲥⲟⲥ	nome_prop_masc
ⲡⲉⲧⲣⲁ	nome_prop_femm
ⲡⲉⲧⲣⲟⲥ	nome_prop_masc
ⲡⲓⲑⲁⲅⲟⲣⲁ	nome_prop_masc
ⲡⲓⲑⲁⲅⲟⲣⲁⲥ	nome_prop_masc
ⲡⲓⲧⲧⲁ	nome_prop_masc
ⲡⲕⲱⲟⲩ	nome_prop_masc
ⲡⲟⲗⲩⲫⲁⲛⲏⲥ	nome_prop_masc
ⲡⲟⲛⲧⲓⲟⲥ	nome_prop_masc
ⲡⲟⲣⲫⲉⲣⲓⲟⲥ	nome_prop_masc
ⲡⲟⲣⲫⲏⲣⲓⲟⲥ	nome_prop_masc
ⲡⲟⲣⲫⲓⲣⲓⲟⲥ	nome_prop_masc
ⲡⲟⲣⲫⲩⲣⲓⲟⲥ	nome_prop_masc
ⲡⲟⲣⲭⲏⲣⲓⲁ	nome_prop_femm
ⲡⲣϭⲟⲩϣ	nome_prop_masc
ⲡⲣⲟⲧⲉⲣⲓⲟⲥ	nome_prop_masc
ⲡⲥⲟⲓ	nome_prop_masc
ⲡⲩⲑⲁⲅⲟⲣⲁ	nome_prop_masc
ⲡⲩⲑⲁⲅⲟⲣⲁⲥ	nome_prop_masc
ⲣⲁⲕⲟⲧⲉ	nome_prop_masc
ⲥⲁⲃⲁ	nome_prop_masc
ⲥⲁⲃⲁⲱⲑ	nome_prop_masc
ⲥⲁⲇⲱⲕ
ⲥⲁⲗⲁⲑⲓⲏⲗ
ⲥⲁⲗⲙⲱⲛ
ⲥⲁⲟⲩⲗ	nome_prop_masc
ⲥⲁⲣⲁⲡⲓⲟⲛ	nome_prop_masc
ⲥⲁⲣⲁⲡⲓⲱⲛ	nome_prop_masc
ⲥⲁⲣⲁⲫⲓⲛ	nome_prop_masc
ⲥⲁⲣⲇⲟⲛⲓⲗⲉ	nome_prop_masc
ⲥⲁⲣⲣⲁ	nome_prop_femm
ⲥⲁⲧⲁⲛⲁⲥ	nome_prop_masc
ⲥⲉⲇⲉⲕⲓⲁⲥ	nome_prop_masc
ⲥⲉⲗⲉⲩⲕⲓⲁ	nome_prop_femm
ⲥⲉⲛⲛⲁⲭⲏⲣⲉⲓⲙ	nome_prop_masc
ⲥⲉⲛⲛⲁⲭⲏⲣⲓⲙ	nome_prop_masc
ⲥⲉⲛⲟⲩⲑⲓⲟⲥ	nome_prop_masc
ⲥⲉⲛⲟⲩⲑⲓⲟⲩ	nome_prop_masc
ⲥⲉⲣⲁⲡⲓⲛ	nome_prop_masc
ⲥⲉⲣⲁⲡⲓⲥ	nome_prop_masc
ⲥⲉⲣⲁⲫⲓⲛ	nome_prop_masc
ⲥⲉⲩⲏⲣⲓⲁⲛⲟⲥ	nome_prop_masc
ⲥⲉⲩⲏⲣⲟⲥ	nome_prop_masc
ⲥⲏⲅⲱⲣ	nome_prop_masc
ⲥⲓⲕⲓⲙⲁ	nome_prop_masc
ⲥⲓⲙⲱⲛ	nome_prop_masc
ⲥⲓⲛⲁ	nome_prop_masc
ⲥⲓⲛⲃⲗϫⲉ	nome_prop_masc
ⲥⲓⲛⲟⲩⲑⲓⲟⲥ	nome_prop_masc
ⲥⲓⲛⲟⲩⲑⲓⲟⲩ	nome_prop_masc
ⲥⲓⲟⲟⲩⲧ	nome_prop_masc
ⲥⲓⲱⲛ	nome_prop_femm
ⲥⲟⲇⲟⲙⲁ	nome_prop_masc
ⲥⲟⲗⲟⲙⲱⲛ	nome_prop_masc
ⲥⲟⲗⲱⲙⲱⲛ	nome_prop_masc
ⲥⲟⲩⲁⲛ	nome_prop_masc
ⲥⲟⲩⲛⲛⲟⲥ	nome_prop_masc
ⲥⲟⲩⲣⲉⲥ	nome_prop_masc
ⲥⲟⲩⲥⲁⲛⲛⲁ	nome_prop_femm
ⲥⲧⲉⲫⲁⲛⲟⲥ	nome_prop_masc
ⲥⲧⲏⲫⲁⲛⲟⲥ	nome_prop_masc
ⲥⲧⲣⲁⲧⲟⲛⲓⲕⲟⲥ	nome_prop_masc
ⲥⲩⲣⲓⲁ	nome_prop_femm
ⲥⲱⲕⲣⲁⲧⲏⲥ	nome_prop_masc
ⲥⲱⲧⲏⲣⲓⲭⲟⲥ	nome_prop_masc
ⲧⲁϩⲱⲙ	nome_prop_femm
ⲧⲁⲙⲁⲥⲕⲟⲥ	nome_prop_masc
ⲧⲁⲙⲙⲁ	nome_prop_masc
ⲧⲁⲛϯⲟⲭⲓⲁ	nome_prop_femm
ⲧⲁⲛⲇⲓⲟⲭⲓⲁ	nome_prop_masc
ⲧⲁⲛⲟⲩⲃⲓⲥ	nome_prop_masc
ⲧⲁⲛⲧⲓⲟⲭⲓⲁ	nome_prop_masc
ⲧⲁⲣⲥⲟⲥ	nome_prop_masc
ⲧⲉⲣⲱⲧ	nome_prop_masc
ⲧⲉⲣⲱⲧⲁϣⲁⲛⲥ	nome_prop_femm
ⲧⲏⲣⲏⲃ	nome_prop_masc
ⲧⲓⲙⲁⲓⲟⲥ	nome_prop_masc
ⲧⲓⲙⲟⲑⲉⲟⲥ	nome_prop_masc
ⲧⲕⲱⲟⲩ	nome_prop_masc
ⲧⲟⲗⲉⲙⲁⲓⲟⲥ	nome_prop_masc
ⲧⲟⲗⲉⲙⲉⲟⲥ	nome_prop_masc
ⲧⲟⲗⲟⲙⲁⲓⲟⲥ	nome_prop_masc
ⲧⲟⲗⲟⲙⲉⲟⲥ	nome_prop_masc
ⲧⲟⲩϩⲱ	nome_prop_masc
ⲧⲩⲣⲁⲛⲟⲥ	nome_prop_masc
ⲧⲩⲣⲟⲥ	nome_prop_masc
ⲫⲁⲣⲁⲱ	nome_prop_masc
ⲫⲁⲣⲉⲥ
ⲫⲁⲩⲥⲧⲟⲥ	nome_prop_masc
ⲫⲏⲗⲓⲝ	nome_prop_masc
ⲫⲓⲃ	nome_prop_masc
ⲫⲓⲗⲓⲡⲡⲟⲥ	nome_prop_masc
ⲫⲓⲛⲉⲉⲥ	nome_prop_masc
ⲫⲩⲗⲓⲝ	nome_prop_masc
ⲭⲁⲗⲁⲛⲏ	nome_prop_masc
ⲭⲁⲗⲕⲉⲇⲱⲛ	nome_prop_masc
ⲭⲁⲗⲕⲏⲇⲱⲛ	nome_prop_masc
ⲭⲁⲗⲕⲩⲇⲱⲛ	nome_prop_masc
ⲭⲁⲛⲁⲁⲛ	nome_prop_masc
ⲭⲁⲛⲁⲛⲁⲓⲁ	nome_prop_femm
ⲭⲟⲓⲁⲭ	nome_prop_masc
ⲭⲣⲓⲥⲧⲓⲁⲛⲏ	nome_prop_femm
ⲭⲣⲓⲥⲧⲟⲥ	nome_prop_masc
ⲭⲱⲣⲏⲃ	nome_prop_masc
ⲱⲣⲓⲅⲉⲛⲏⲥ	nome_prop_masc
ⲱⲥⲏⲉ	nome_prop_masc
ⲓⲏⲥⲟⲩⲥ	nome_prop_masc
ⲓⲱϩⲁⲛⲛⲏⲥ	nome_prop_masc
ⲓⲁⲕⲱⲃ	nome_prop_masc
ⲥⲁⲧⲁⲛⲁⲥ	nome_prop_masc
ⲥⲓⲙⲱⲛ	nome_prop_masc
ⲓⲁⲕⲱⲃⲟⲥ	nome_prop_masc
ⲁⲃⲣⲁϩⲁⲙ	nome_prop_masc
ⲓⲥⲁⲁⲕ	nome_prop_masc
ⲭⲣⲓⲥⲧⲟⲥ	nome_prop_masc
ϩⲏⲣⲱⲇⲏⲥ	nome_prop_masc
ⲅⲁⲗⲓⲗⲁⲓⲁ	nome_prop_femm
ϩⲣⲁⲭⲏⲗ
ⲥⲁⲣⲣⲁ	nome_prop_femm
ϩⲣⲉⲃⲉⲕⲕⲁ
ⲍⲉⲃⲉⲇⲁⲓⲟⲥ
ⲏⲥⲁⲩ
ⲏⲥⲁⲓⲁⲥ	nome_prop_masc
ⲓⲟⲣⲇⲁⲛⲏⲥ	nome_prop_masc
ϩⲓⲉⲣⲟⲥⲟⲗⲩⲙⲁ
ⲙⲱⲩⲥⲏⲥ	nome_prop_masc
ⲁⲛⲇⲣⲉⲁⲥ	nome_prop_masc
ⲡⲁⲩⲗⲟⲥ	nome_prop_masc
ϩⲏⲣⲱⲇⲓⲁⲥ
ⲫⲓⲗⲓⲡⲡⲟⲥ	nome_prop_masc
ⲁⲛⲛⲁ
ⲁⲫⲑⲟⲛⲓⲁ
ⲓⲟⲩⲇⲁⲥ	nome_prop_masc
ⲓⲥⲣⲁⲏⲗ	nome_prop_masc
ϩⲓⲉⲣⲟⲩⲥⲁⲗⲏⲙ	nome_prop_masc
ⲡⲉⲧⲣⲟⲥ	nome_prop_masc
ⲕⲁⲫⲁⲣⲛⲁⲟⲩⲙ	nome_prop_masc
ⲃⲁⲗⲗⲁ
ⲓⲟⲩⲇⲁⲓⲁ
ⲉⲩϩⲁ
ⲓⲱⲥⲏ
ⲍⲉⲗⲫⲁ
ⲑⲱⲙⲁⲥ
ⲓⲟⲩⲇⲁ
ⲓⲱⲥⲏⲫ	nome_prop_masc
ⲙⲁⲣⲓⲁ	nome_prop_femm
ⲓⲥⲙⲁⲏⲗ
ⲡⲉⲧⲣⲁ	nome_prop_femm
ⲓⲱϩⲁⲛⲏⲥ
ⲧⲩⲣⲟⲥ	nome_prop_masc
ⲉⲗⲓⲥⲁⲃⲉⲧ
ⲓⲱⲥⲓⲁⲥ
ⲡⲣⲟⲥⲟⲩⲟⲉⲓϣ
ⲕⲁⲣⲡⲟⲥ	sost_grec_masc_sipl
ⲇⲉⲃⲃⲱⲣⲁ
ϩⲏⲗⲉⲓⲁⲥ	nome_prop_masc
ⲟⲇⲟⲗⲗⲁ
ⲇⲁⲩⲉⲓⲇ	nome_prop_masc
ⲥⲉⲛⲟⲩⲑⲓⲟⲩ	nome_prop_masc
ⲃⲁⲣⲑⲟⲗⲟⲙⲁⲓⲟⲥ
ⲫⲁⲛⲟⲩⲏⲗ
ⲓⲉⲣⲉⲙⲓⲁⲥ	nome_prop_masc
ⲇⲓⲁⲃⲟⲗⲟⲥ	sost_grec_masc_sipl
ⲓⲉⲍⲉⲕⲓⲥⲣⲁⲏⲗ
ⲗⲓⲁ
ⲛⲟⲏ	nome_prop_femm
ⲃⲉⲛⲓⲁⲙⲓⲛ
ⲥⲁⲙⲯⲱⲛ
ⲁⲃⲓⲁⲑⲁⲣ
ⲧⲁⲗⲉⲓⲑⲁ
ⲛⲁⲍⲁⲣⲉⲑ	nome_prop_masc
ⲁⲗⲉⲝⲁⲛⲇⲣⲟⲥ	nome_prop_masc
ⲉⲫⲣⲉⲙ
ⲙⲁⲙⲙⲱⲛⲁⲥ
ϣⲟⲙⲛⲧ	nume_spec
ⲟⲩⲁ	sost_asso_egiz_masc_siplnume
ⲥⲉ	refe_partnumeinte_egizsost_verb_nomi
ϯ	refe_partrefe_dimonumesost_verb_assosost_verb_nomi
ⲛⲁⲓ	refe_dimo
ⲛⲉⲓ	refe_dimo
ⲛⲓ	refe_dimo
ⲡⲁⲓ	refe_dimo
ⲡⲉⲓ	refe_dimo
ⲡⲓ	refe_dimo
ⲧⲁⲓ	refe_dimo
ⲧⲉⲓ	refe_dimo
ⲁϣ	sost_asso_egiz_mafe_sipl
ⲛⲓⲙ	agge_asso
ⲟⲩ	refe_partarinsost_asso_egiz_mafe_sipl
ⲟⲩⲏⲣ	agge_asso
ⲁⲛⲅ	refe_nomi
ⲁⲛⲟⲕ	refe_asso
ⲁⲛⲟⲛ	refe_asso
ⲁⲛ	nega
ⲛⲧⲉ	refe_nomitripprep_egiz_nomi
ⲛⲧⲉⲧⲛ	refe_nomi
ⲛⲧⲕ	refe_nomi
ⲛⲧⲟ	refe_asso
ⲛⲧⲟϥ	refe_asso
ⲛⲧⲟⲕ	refe_asso
ⲛⲧⲟⲟⲩ	refe_asso
ⲛⲧⲟⲥ	refe_asso
ⲛⲧⲱⲧⲛ	refe_asso
ϥ	refe_part
ⲉ	trip_eyan_inizconv_circconv_relaconv_secoprep_nomi_egiz
ⲓ	refe_partsost_verb_asso
ⲕ	refe_part
ⲛ	refe_partrefe_dimo_artinegatripconvprep_nomi_egizattrsost_verb_nomisost_verb_pron
ⲟⲩ	refe_partarinsost_asso_egiz_mafe_sipl
ⲥ	refe_part
ⲥⲉ	refe_partnumeinte_egizsost_verb_nomi
ⲥⲟⲩ	refe_partadnu
ⲧ	refe_partrefe_dimo_artirefe_dimo_pron
ⲧⲉ	refe_partrefe_dimo_artirefe_dimo_pronrefe_dimo_bipn
ⲧⲏⲩⲧⲛ	refe_part_spec
ⲧⲛ	refe_part
ⲩ	refe_partarin
ϥ	refe_part
ϯ	refe_partrefe_dimonumesost_verb_assosost_verb_nomi
ⲅ	refe_part
ⲓ	refe_partsost_verb_asso
ⲕ	refe_part
ⲛ	refe_partrefe_dimo_artinegatripconvprep_nomi_egizattrsost_verb_nomisost_verb_pron
ⲟⲩ	refe_partarinsost_asso_egiz_mafe_sipl
ⲥ	refe_part
ⲥⲉ	refe_partnumeinte_egizsost_verb_nomi
ⲧⲉ	refe_partrefe_dimo_artirefe_dimo_pronrefe_dimo_bipn
ⲧⲉⲧⲛ	refe_part
ⲧⲛ	refe_part
ⲩ	refe_partarin
ⲛⲁ	refe_dimo_possrefe_dimo_pronfutuprep_pron_egizsost_verb_asso
ⲛⲉϥ
ⲛⲉⲕ
ⲛⲉⲛ
ⲛⲉⲥ
ⲛⲉⲧⲛ
ⲛⲉⲩ
ⲛⲟⲩ	refe_dimo_posssost_verb_asso
ⲡⲁ	refe_dimo_possrefe_dimo_pron
ⲡⲉϥ
ⲡⲉⲕ
ⲡⲉⲛ
ⲡⲉⲥ
ⲡⲉⲧⲛ
ⲡⲉⲩ
ⲡⲟⲩ
ⲧⲁ	part_triprefe_partrefe_dimo_possrefe_dimo_pron
ⲧⲉϥ
ⲧⲉⲕ
ⲧⲉⲛ	refe_part
ⲧⲉⲥ
ⲧⲉⲧⲛ	refe_part
ⲧⲉⲩ
ⲧⲟⲩ
ϣⲁ	tripprep_nomi_egizsost_verb_asso
ϣⲁⲣⲟ	prep_pron_egiz
ϣⲁⲣⲱ
ϣⲁⲧⲛ	prep_nomi_egiz
ϣⲉⲡⲟⲩϫⲁⲓ	prep_nomi_egiz
ϩⲁ	prep_nomi_egiz
ϩⲁϩⲧⲏ	prep_pron_egiz
ϩⲁϩⲧⲙ	prep_nomi_egiz
ϩⲁϩⲧⲛ	prep_nomi_egiz
ϩⲁⲉⲓⲁⲧ	prep_pron_egiz
ϩⲁⲣⲁⲧ	prep_pron_egiz
ϩⲁⲣⲓϩⲁⲣⲟ	prep_pron_egiz
ϩⲁⲣⲟ	prep_pron_egiz
ϩⲁⲣⲱ	prep_pron_egiz
ϩⲁⲧⲉ	prep_nomi_egizsost_verb_asso
ϩⲁⲧⲏ	prep_pron_egiz
ϩⲁⲧⲙ	prep_nomi_egiz
ϩⲁⲧⲛ
ϩⲁⲧⲟⲟⲧ	prep_pron_egiz
ϩⲉⲛ	arinprep_nomi_egiz
ϩⲏⲧϥⲙ	prep_nomi_egiz
ϩⲓ	prep_nomi_egiz
ϩⲓϫⲉⲛ	prep_nomi_egiz
ϩⲓϫⲙ	prep_nomi_egiz
ϩⲓϫⲛ	prep_nomi_egiz
ϩⲓϫⲱ	prep_pron_egiz
ϩⲓⲣⲙ	prep_nomi_egiz
ϩⲓⲣⲛ	prep_nomi_egiz
ϩⲓⲣⲱ	prep_pron_egiz
ϩⲓⲧⲉ	prep_pron_egiz
ϩⲓⲧⲉⲙ	prep_nomi_egiz
ϩⲓⲧⲙ	prep_nomi_egiz
ϩⲓⲧⲛ	prep_nomi_egiz
ϩⲓⲧⲟⲟ	prep_pron_egiz
ϩⲓⲧⲟⲟⲧ	prep_pron_egizsost_verb_pron
ϩⲓⲧⲟⲩⲱ	prep_pron_egiz
ϩⲓⲱ	prep_pron_egiz
ϩⲓⲱⲧ	prep_nomi_egiz
ϩⲓⲱⲱ	prep_pron_egiz
ϩⲙ	prep_nomi_egiz
ϩⲛ	arinprep_nomi_egiz
ϩⲛⲛⲉϩⲟⲟⲩⲛ	prep_nomi_egiz
ϩⲛⲧⲙⲏⲧⲉⲙ	prep_nomi_egiz
ϩⲛⲧⲙⲏⲧⲉⲛ	prep_nomi_egiz
ϩⲣⲁⲓϩⲙ	prep_nomi_egiz
ϩⲣⲁⲓϩⲛ	prep_nomi_egiz
ϫⲓ	avve_egizprep_nomi_egizsost_verb_assosost_verb_nomisost_verb_pron
ϫⲓⲛ	avve_egizprep_nomi_egiz
ϫⲓⲛⲉ	prep_nomi_egiz
ϫⲓⲛⲙ	prep_nomi_egiz
ϫⲓⲛⲛ	prep_nomi_egiz
ⲁϫⲙ	prep_nomi_egiz
ⲁϫⲛ	prep_nomi_egiz
ⲁϫⲛⲧ	prep_pron_egiz
ⲁⲛⲧⲓ	prep_nomi_grec
ⲉ	trip_eyan_inizconv_circconv_relaconv_secoprep_nomi_egiz
ⲉϩⲣⲁ	prep_pron_egiz
ⲉϩⲣⲁⲓⲉ	prep_nomi_egiz
ⲉϩⲣⲁⲓⲉϫⲙ	prep_nomi_egiz
ⲉϩⲣⲁⲓⲉϫⲛ	prep_nomi_egiz
ⲉϩⲣⲁⲓⲉϫⲱ	prep_pron_egiz
ⲉϫⲙ	prep_nomi_egiz
ⲉϫⲛ	prep_nomi_egiz
ⲉϫⲛϩⲉ	prep_nomi_egiz
ⲉϫⲛⲧⲉ	prep_pron_egiz
ⲉϫⲱ	prep_pron_egiz
ⲉⲡⲙⲁⲙ	prep_nomi_egiz
ⲉⲡⲙⲁⲛ	prep_nomi_egiz
ⲉⲣⲁ	prep_pron_egiz
ⲉⲣⲁⲧ	prep_pron_egiz
ⲉⲣⲁⲧⲟⲩ	prep_pron_egiz
ⲉⲣⲙ	prep_nomi_egiz
ⲉⲣⲛ	prep_nomi_egiz
ⲉⲣⲟ	prep_pron_egiz
ⲉⲣⲱ	prep_pron_egiz
ⲉⲧⲃⲉ	prep_nomi_egiz
ⲉⲧⲃⲏⲏ	prep_pron_egiz
ⲉⲧⲃⲏⲏⲧ	prep_pron_egiz
ⲉⲧⲙⲏⲧⲉⲛ	prep_nomi_egiz
ⲉⲧⲟⲟⲧ	prep_pron_egiz
ⲕⲁⲧⲁ	prep_nomi_grec
ⲕⲁⲧⲁⲣⲟ	prep_pron_egiz
ⲕⲁⲧⲁⲣⲱ	prep_pron_egiz
ⲙ	refe_dimo_artinegaprep_egiz_nomiattrsost_verb_asso
ⲙⲉⲭⲣⲓ	prep_nomi_grec
ⲙⲙⲟ	prep_pron_egiz
ⲙⲙⲱ	prep_pron_egiz
ⲙⲛ	esisprep_nomi_egiz
ⲙⲛⲛⲥⲁ	prep_nomi_egiz
ⲙⲛⲛⲥⲱ	prep_pron_egiz
ⲙⲡϩⲟⲩⲛⲛ	prep_nomi_egiz
ⲙⲡϩⲣⲉⲙ	prep_nomi_egiz
ⲙⲡϩⲱⲧⲉⲃⲟⲗⲙ	prep_nomi_egiz
ⲙⲡϩⲱⲧⲉⲃⲟⲗⲛ	prep_nomi_egiz
ⲙⲡⲁⲙⲧⲟⲉⲃⲟⲗ	prep_pron_egiz
ⲙⲡⲁⲣⲁ	prep_nomi_egiz
ⲙⲡⲃⲟⲗⲛ	prep_nomi_egiz
ⲙⲡⲉⲓⲥⲙⲟⲧⲙ	prep_nomi_egiz
ⲙⲡⲉⲓⲥⲙⲟⲧⲛ	prep_nomi_egiz
ⲙⲡⲉⲙⲧⲟⲉⲃⲟⲗⲙ	prep_nomi_egiz
ⲙⲡⲉⲥⲙⲟⲧⲙ	prep_nomi_egiz
ⲙⲡⲉⲥⲙⲟⲧⲛ	prep_nomi_egiz
ⲙⲡⲙϩⲓⲧⲛ	prep_nomi_egiz
ⲙⲡⲙⲧⲟⲉⲃⲟⲗⲙ	prep_nomi_egiz
ⲙⲡⲙⲧⲟⲉⲃⲟⲗⲛ	prep_nomi_egiz
ⲙⲡⲛⲁⲩⲙ	prep_nomi_egiz
ⲙⲡⲛⲁⲩⲛ	prep_nomi_egiz
ⲙⲡⲛⲁⲩⲛⲙ	prep_nomi_egiz
ⲛ	refe_partrefe_dimo_artinegatripconvprep_nomi_egizattrsost_verb_nomisost_verb_pron
ⲛϩⲏ	prep_pron_egiz
ⲛϩⲏⲧ	prep_pron_egiz
ⲛⲁ	refe_dimo_possrefe_dimo_pronfutuprep_pron_egizsost_verb_asso
ⲛⲁϩⲣⲁ	prep_pron_egiz
ⲛⲁϩⲣⲉⲙ	prep_nomi_egiz
ⲛⲁϩⲣⲉⲛ	prep_nomi_egiz
ⲛⲁϩⲣⲙ	prep_nomi_egiz
ⲛⲁϩⲣⲛ	prep_nomi_egiz
ⲛⲏ	refe_dimoprep_pron_egiz
ⲛⲏⲧⲛ	prep_pron_egiz
ⲛⲑⲉⲙ	prep_nomi_egiz
ⲛⲑⲉⲛ	prep_nomi_egiz
ⲛⲙ
ⲛⲙⲙ
ⲛⲙⲙⲁ	prep_pron_egiz
ⲛⲙⲙⲏ	prep_pron_egiz
ⲛⲛⲁϩⲣⲁ	prep_pron_egiz
ⲛⲛⲁϩⲣⲉⲙ	prep_nomi_egiz
ⲛⲛⲁϩⲣⲉⲛ	prep_nomi_egiz
ⲛⲛⲁϩⲣⲏ	prep_pron_egiz
ⲛⲛⲁϩⲣⲙ	prep_nomi_egiz
ⲛⲛⲁϩⲣⲛ	prep_nomi_egiz
ⲛⲟⲩⲃⲏϭ	prep_nomi_egiz
ⲛⲣⲁⲧ	prep_pron_egiz
ⲛⲥⲁ	prep_nomi_egiz
ⲛⲥⲁⲃⲗⲗⲁ	prep_pron_egiz
ⲛⲥⲱ	prep_pron_egiz
ⲛⲧⲉ	refe_nomitripprep_egiz_nomi
ⲛⲧⲉⲡⲟⲩⲟⲉⲓⲛ	prep_nomi_egiz
ⲛⲧⲙ	prep_nomi_egiz
ⲛⲧⲛ	prep_nomi_egiz
ⲛⲧⲟⲟⲧ	prep_pron_egiz
ⲛⲧⲡⲉⲛ	prep_nomi_egiz
ⲟⲩⲃⲉ	prep_nomi_egiz
ⲟⲩⲃⲏ	prep_pron_egiz
ⲟⲩⲧⲉ	cong_grecprep_egiz_nomi
ⲟⲩⲧⲱ	prep_egiz_pron
ⲡⲁⲣⲁ	prep_nomi_grec
ⲡⲣⲟⲥ	prep_nomi_grec
ⲧⲁⲓⲧⲉⲑⲉⲛ	prep_nomi_egiz
ⲭⲱⲣⲓⲥ	prep_nomi_grec
ⲛ	refe_partrefe_dimo_artinegatripconvprep_nomi_egizattrsost_verb_nomisost_verb_pron
ⲉ	trip_eyan_inizconv_circconv_relaconv_secoprep_nomi_egiz
ⲙ	refe_dimo_artinegaprep_egiz_nomiattrsost_verb_asso
ⲙⲛ	esisprep_nomi_egiz
ϩⲛ	arinprep_nomi_egiz
ⲙⲙⲟ	prep_pron_egiz
ⲛⲁ	refe_dimo_possrefe_dimo_pronfutuprep_pron_egizsost_verb_asso
ⲉⲣⲟ	prep_pron_egiz
ϩⲙ	prep_nomi_egiz
ⲉⲧⲃⲉ	prep_nomi_egiz
ⲕⲁⲧⲁ	prep_nomi_grec
ⲛⲙⲙⲁ	prep_pron_egiz
ⲛϩⲏⲧ	prep_pron_egiz
ϩⲓ	prep_nomi_egiz
ⲛⲥⲱ	prep_pron_egiz
ⲛⲧⲉ	refe_nomitripprep_egiz_nomi
ϩⲓⲧⲙ	prep_nomi_egiz
ϫⲓⲛ	avve_egizprep_nomi_egiz
ⲛⲥⲁ	prep_nomi_egiz
ϩⲁ	prep_nomi_egiz
ⲛⲏ	refe_dimoprep_pron_egiz
ⲛⲙ
ⲉϫⲱ	prep_pron_egiz
ⲉϫⲛ	prep_nomi_egiz
ⲉⲧⲃⲏⲏⲧ	prep_pron_egiz
ϣⲁ	tripprep_nomi_egizsost_verb_asso
ⲉⲣⲱ	prep_pron_egiz
ⲙⲙⲱ	prep_pron_egiz
ϩⲓϫⲛ	prep_nomi_egiz
ϩⲁⲣⲟ	prep_pron_egiz
ϩⲁⲧⲛ
ⲉⲣⲁⲧ	prep_pron_egiz
ⲛⲙⲙ
ϩⲁⲣⲁⲧ	prep_pron_egiz
ϩⲓϫⲱ	prep_pron_egiz
ⲉⲧⲟⲟⲧ	prep_pron_egiz
ⲛⲧⲟⲟⲧ	prep_pron_egiz
ⲉϫⲙ	prep_nomi_egiz
ϩⲓϫⲙ	prep_nomi_egiz
ⲙⲛⲛⲥⲁ	prep_nomi_egiz
ϣⲁⲣⲟ	prep_pron_egiz
ϣⲁⲣⲱ
ϩⲓⲱⲱ	prep_pron_egiz
ⲁϫⲛ	prep_nomi_egiz
ϩⲁⲧⲏ	prep_pron_egiz
ϩⲓⲧⲛ	prep_nomi_egiz
ϩⲓⲧⲟⲩⲱ	prep_pron_egiz
ⲉⲧⲃⲏⲏ	prep_pron_egiz
ⲛⲙⲙⲏ	prep_pron_egiz
ⲛⲁϩⲣⲛ	prep_nomi_egiz
ⲙⲛⲛⲥⲱ	prep_pron_egiz
ϩⲓⲱ	prep_pron_egiz
ϩⲁϩⲧⲏ	prep_pron_egiz
ⲉϩⲟⲩⲉ
ϩⲁⲣⲱ	prep_pron_egiz
ϩⲁⲧⲉ	prep_nomi_egizsost_verb_asso
ϩⲓⲣⲙ	prep_nomi_egiz
ⲉϩⲣⲁ	prep_pron_egiz
ⲟⲩⲃⲏ	prep_pron_egiz
ⲧⲟⲟⲧ	sost_asso_egiz_masc_sipl
ⲭⲱⲣⲓⲥ	prep_nomi_grec
ϫⲓ	avve_egizprep_nomi_egizsost_verb_assosost_verb_nomisost_verb_pron
ϩⲣⲁⲓ	avve_egizavve_egiz
ϩⲓⲧⲟⲟⲧ	prep_pron_egizsost_verb_pron
ⲛϩⲧⲏ
ϩⲁⲧⲏ	prep_pron_egiz
ⲉϫⲱ	prep_pron_egiz
ⲉⲣⲟ	prep_pron_egiz
ⲙⲙⲟ	prep_pron_egiz
ⲛⲥⲱ	prep_pron_egiz
ϩⲁⲙⲏⲛ	inte_grec
ⲁⲩⲉⲓⲥ	inte_egiz
ⲅⲁⲣ	cong_grec
ⲇⲉ	cong_grec
ⲉⲓⲉ	tripinte_egiz
ⲉⲓⲥ	prep_nomi_grecinte_egiz
ⲉⲓⲥϩⲏⲏⲧⲉ	inte_egiz
ⲙⲉⲅⲉⲛⲟⲓⲧⲟ	inte_grec
ⲙⲏⲅⲉⲛⲟⲉⲓⲧⲟ	inte_grec
ⲙⲏⲅⲉⲛⲟⲓⲧⲟ	inte_grec
ⲙⲓⲟⲕ	inte_egiz
ⲙⲡⲉ	tripinte_egiz
ⲛϭⲓ	sopo
ⲛⲛⲉⲥϣⲱⲡⲉ	inte_egiz
ⲟⲩⲟⲉⲓⲛⲁ	inte_grec
ⲟⲩⲟⲉⲓⲛⲏⲧⲛ	inte_grec
ⲟⲩⲟⲓⲛⲁ	inte_grec
ⲟⲩⲟⲓⲛⲏⲧⲛ	inte_grec
ⲣⲱ	cong_egizsost_egiz_pron
ⲥⲉ	refe_partnumeinte_egizsost_verb_nomi
ⲭⲁⲉⲓⲣⲉ	inte_grec
ⲭⲁⲓⲣⲉ	inte_grec
ⲭⲁⲓⲣⲉⲧⲉ	inte_grec
ⲱ	inte_grecsost_verb_asso
,
]
·ⲻ
[
.
:
·
ⲻ
ⲉ[.....]
ⲉⲃ[........]
ⲟⲩⲇ[.......]
ⲡ̣[…]ⲡⲟⲥ
ⲡⲁ[…]ϥⲟϭⲉ
ϣ	sost_verb_nomi
ϣϣⲉ	verb_imps
ϣϥ	sost_verb_nomi
ϣϭⲁ	sost_verb_nomi
ϣϭⲟⲙ	sost_verb_asso
ϣⲁ	tripprep_nomi_egizsost_verb_asso
ϣⲁϥⲉ	sost_verb_asso
ϣⲁϩ	sost_asso_egiz_masc_siplsost_verb_asso
ϣⲁϫⲉ	sost_verb_asso
ϣⲁⲁⲧ	sost_verb_pronqual
ϣⲁⲧ	sost_verb_pron
ϣⲃv	sost_verb_asso
ϣⲃⲃ	sost_verb_pron
ϣⲃⲧ	sost_verb_pron
ϣⲉϥ	sost_verb_nomi
ϣⲉⲙϣⲉ	sost_verb_asso
ϣⲉⲛⲉ	sost_verb_nomi
ϣⲉⲛⲉϩⲧⲏ	sost_verb_pron
ϣⲉⲡ	sost_verb_nomi
ϣⲉⲡϣⲡ
ϣⲉⲡϩⲓⲥⲉ	sost_verb_asso
ϣⲉⲡϩⲙⲟⲧ	sost_verb_asso
ϣⲉⲣϣⲱⲣ	sost_verb_pron
ϣⲉⲥ	sost_verb_nomi
ϣⲓⲃⲉ	sost_verb_asso
ϣⲓⲕⲉ	sost_verb_asso
ϣⲓⲛⲉ	sost_verb_asso
ϣⲓⲛⲉⲛⲥⲁ	sost_verb_nomi
ϣⲓⲧⲉ	sost_verb_asso
ϣⲕⲉⲗⲕⲉⲗ	sost_verb_asso
ϣⲗⲏⲗ	sost_verb_asso
ϣⲗⲗ	sost_verb_asso
ϣⲙϣⲉ	sost_verb_asso
ϣⲙϣⲉⲉⲓⲇⲱⲗⲟⲛ	sost_verb_asso
ϣⲙⲁ	sost_verb_asso
ϣⲟⲗϥ	sost_verb_pron
ϣⲟⲗⲉ	sost_verb_pron
ϣⲟⲗⲕ	sost_verb_pron
ϣⲟⲗⲛ	sost_verb_pron
ϣⲟⲗⲟⲩ	sost_verb_pron
ϣⲟⲗⲥ	sost_verb_pron
ϣⲟⲛϥ	sost_verb_pron
ϣⲟⲟⲛ	sost_verb_pron
ϣⲟⲟⲩⲉ	sost_verb_asso
ϣⲟⲡ	sost_verb_pron
ϣⲟⲣϣⲣ	sost_verb_asso
ϣⲟⲩϣⲟⲩ	sost_verb_asso
ϣⲟⲩⲉ	sost_verb_nomi
ϣⲟⲩⲟ	sost_verb_asso
ϣⲡ	sost_verb_nomi
ϣⲡϩⲓⲥⲉ	sost_verb_asso
ϣⲡϩⲙⲟⲧ	sost_verb_asso
ϣⲡⲟⲛ	sost_verb_pron
ϣⲡⲧⲱⲣⲉ	sost_verb_asso
ϣⲣϣⲱⲣ	sost_verb_pronqual
ϣⲣⲡ	sost_verb_nomi
ϣⲣⲡϣⲁϫⲉ	sost_verb_asso
ϣⲣⲡⲧⲁⲙⲟ	sost_verb_asso
ϣⲧⲁⲙ	sost_verb_assosost_verb_nomi
ϣⲧⲉⲣⲧⲱⲣ	sost_verb_pron
ϣⲧⲟⲙ	sost_verb_asso
ϣⲧⲟⲣⲧⲉⲣ	sost_verb_asso
ϣⲧⲟⲣⲧⲣ	sost_verb_asso
ϣⲧⲣⲧⲣ	sost_verb_nomi
ϣⲧⲣⲧⲱⲣ	sost_verb_pronqual
ϣⲱϣ	sost_verb_asso
ϣⲱϥ	sost_verb_asso
ϣⲱϥⲧ	sost_verb_asso
ϣⲱϫⲡ	sost_verb_asso
ϣⲱⲗ	sost_verb_asso
ϣⲱⲗϩ	sost_verb_asso
ϣⲱⲗⲙ	sost_verb_asso
ϣⲱⲛⲉ	sost_verb_asso
ϣⲱⲛⲧ	sost_verb_asso
ϣⲱⲡ	sost_verb_asso
ϣⲱⲡⲉ	sost_verb_asso
ϣⲱⲣⲡ	sost_verb_asso
ϣⲱⲱⲧ	sost_verb_asso
ϥⲉϭ	sost_verb_nomi
ϥⲓ	sost_verb_assosost_verb_nomi
ϥⲓϩⲣⲁⲩ	sost_verb_asso
ϥⲓⲡⲣⲟⲟⲩϣ	sost_verb_asso
ϥⲓⲧ	sost_verb_pron
ϥⲟϭ	sost_verb_pron
ϥⲟⲗ	sost_verb_pron
ϥⲟⲧ	sost_verb_pron
ϥⲱϭⲉ	sost_verb_asso
ϥⲱⲧⲉ	sost_verb_asso
ϥⲱⲱⲣⲉ	sost_verb_asso
ϩⲁⲣⲉϩ	sost_verb_asso
ϩⲁⲣⲡⲁⲍⲉ	sost_verb_grec
ϩⲁⲧⲉ	prep_nomi_egizsost_verb_asso
ϩⲉ	sost_asso_egiz_femm_siplsost_verb_asso
ϩⲉϫϩⲱϫ	sost_verb_pron
ϩⲉⲃⲥ	sost_verb_nomi
ϩⲉⲉϩⲣⲁⲓ	sost_verb_asso
ϩⲉⲗⲡⲓⲍⲉ	sost_verb_grec
ϩⲉⲡ	sost_verb_nomi
ϩⲉⲣⲙⲏⲛⲉⲩⲉ	sost_verb_grec
ϩⲉⲧϩⲱⲧ	sost_verb_pron
ϩⲉⲧⲃ	sost_verb_nomi
ϩⲓⲗⲁ	sost_verb_asso
ϩⲓⲛⲏⲃ	sost_verb_asso
ϩⲓⲟⲩⲉ	sost_verb_asso
ϩⲓⲥⲁⲅⲅⲉⲗⲟⲥ	sost_verb_grec
ϩⲓⲥⲇⲟⲣⲓⲍⲉ	sost_verb_grec
ϩⲓⲥⲇⲱⲣⲓⲍⲉ	sost_verb_grec
ϩⲓⲥⲧⲟⲣⲓⲍⲉ	sost_verb_grec
ϩⲓⲥⲧⲱⲣⲓⲍⲉ	sost_verb_grec
ϩⲓⲧⲟⲟⲧ	prep_pron_egizsost_verb_pron
ϩⲓⲱⲛⲉ	sost_verb_asso
ϩⲕⲟ	sost_verb_asso
ϩⲗⲟϭ	sost_verb_asso
ϩⲙⲙⲉ	sost_verb_asso
ϩⲙⲟⲟⲥ	sost_verb_asso
ϩⲟϫϩϫ	sost_verb_asso
ϩⲟϫϩⲉϫ	sost_verb_asso
ϩⲟⲃⲥ	sost_verb_pron
ϩⲟⲕ	sost_verb_pron
ϩⲟⲙⲏⲗⲉⲓ	sost_verb_grec
ϩⲟⲙⲟⲗⲟⲅⲉⲓ	sost_verb_grec
ϩⲟⲛ	sost_verb_pron
ϩⲟⲡ	sost_verb_pron
ϩⲟⲣ	sost_verb_pron
ϩⲟⲧϩⲉⲧ	sost_verb_asso
ϩⲟⲧϩⲧ	sost_verb_asso
ϩⲟⲧⲃ	sost_verb_pron
ϩⲟⲧⲃⲉ	sost_verb_pron
ϩⲣⲟϣ	sost_verb_asso
ϩⲣⲟⲕ	sost_verb_asso
ϩⲧⲟⲙⲧⲉⲙ	sost_verb_asso
ϩⲧⲟⲙⲧⲙ	sost_verb_asso
ϩⲩⲡⲉⲣⲉⲓⲧⲉⲓ	sost_verb_grec
ϩⲩⲡⲉⲣⲉⲧⲉⲓ	sost_verb_grec
ϩⲩⲡⲉⲣⲏⲧⲉⲓ	sost_verb_grec
ϩⲩⲡⲟⲅⲟⲣⲉⲩⲉ	sost_verb_grec
ϩⲩⲡⲟⲅⲣⲁⲫⲉ	sost_verb_grec
ϩⲩⲡⲟⲅⲣⲁⲫⲏ	sost_verb_grec
ϩⲩⲡⲟⲕⲓⲥⲑⲁⲓ	sost_verb_grec
ϩⲩⲡⲟⲕⲓⲥⲑⲉ	sost_verb_grec
ϩⲩⲡⲟⲕⲣⲓⲛⲉ	sost_verb_grec
ϩⲩⲡⲟⲙⲉⲓⲛⲉ	sost_verb_grec
ϩⲩⲡⲟⲙⲓⲛⲉ	sost_verb_grec
ϩⲩⲡⲟⲧⲁⲥⲥⲉ	sost_verb_grec
ϩⲱ	agge_assoagge_pronsost_verb_asso
ϩⲱϣ	sost_verb_asso
ϩⲱϥⲧ	sost_verb_asso
ϩⲱϭⲃ	sost_verb_asso
ϩⲱⲃⲥ	sost_verb_asso
ϩⲱⲕ	sost_verb_asso
ϩⲱⲗ	sost_verb_asso
ϩⲱⲙ	sost_verb_asso
ϩⲱⲛ	sost_verb_asso
ϩⲱⲛⲧ	sost_verb_asso
ϩⲱⲟⲩ	sost_verb_asso
ϩⲱⲡ	sost_verb_asso
ϩⲱⲣϭ	sost_verb_asso
ϩⲱⲣⲃ	sost_verb_asso
ϩⲱⲣⲡ
ϩⲱⲧⲃ	sost_verb_asso
ϩⲱⲧⲡ	sost_verb_asso
ϫⲁϩⲙ	sost_verb_pronqual
ϫⲁⲥⲧ	sost_verb_pron
ϫⲁⲥⲧⲉ	sost_verb_pron
ϫⲉ	cong_egizsost_verb_nomi
ϫⲉϭⲟⲗ	sost_verb_asso
ϫⲉⲕ	sost_verb_nomi
ϫⲉⲕϫⲓⲕ	sost_verb_asso
ϫⲉⲟⲩⲁ	sost_verb_asso
ϫⲉⲣⲟ	sost_verb_asso
ϫⲉⲣⲱ	sost_verb_pron
ϫⲉⲣⲱϥ	sost_verb_asso
ϫⲉⲩ	sost_verb_nomi
ϫⲓ	avve_egizprep_nomi_egizsost_verb_assosost_verb_nomisost_verb_pron
ϫⲓϣⲓⲡⲉ	sost_verb_asso
ϫⲓϣⲕⲁⲕⲉⲃⲟⲗ	sost_verb_asso
ϫⲓϩⲁⲡ	sost_verb_asso
ϫⲓϩⲟ	sost_verb_asso
ϫⲓϩⲣⲃ	sost_verb_asso
ϫⲓϭⲟⲗ	sost_verb_asso
ϫⲓϯⲡⲉ	sost_verb_asso
ϫⲓⲙⲟⲉⲓⲧ	sost_verb_asso
ϫⲓⲟⲟⲣ	sost_verb_asso
ϫⲓⲟⲩⲁ	sost_verb_asso
ϫⲓⲟⲩⲉ	sost_verb_asso
ϫⲓⲡⲟⲩⲱ	sost_verb_asso
ϫⲓⲥϩⲓⲙⲉ	sost_verb_asso
ϫⲓⲥⲃⲱ	sost_verb_asso
ϫⲓⲥⲉ	sost_verb_asso
ϫⲓⲥⲉⲛϩⲏⲧ	sost_verb_asso
ϫⲓⲥⲙⲟⲩ	sost_verb_asso
ϫⲓⲥⲱϣ	sost_verb_asso
ϫⲓⲧ	sost_verb_pron
ϫⲓⲧⲓⲡⲉ	sost_verb_asso
ϫⲓⲧⲟ	sost_verb_asso
ϫⲛⲉ	sost_verb_nomi
ϫⲛⲟⲩ	sost_verb_assosost_verb_pron
ϫⲟ	sost_verb_assosost_verb_pron
ϫⲟⲕ	sost_verb_pron
ϫⲟⲕⲉⲣ	sost_verb_asso
ϫⲟⲕⲣ	sost_verb_asso
ϫⲟⲟ	sost_verb_pron
ϫⲟⲟⲃⲉ	sost_verb_pron
ϫⲟⲟⲣ	sost_verb_pronqual
ϫⲟⲟⲣⲉ	sost_verb_pronqual
ϫⲟⲟⲩ	sost_verb_asso
ϫⲟⲟⲩⲉⲣⲁⲧ	sost_verb_asso
ϫⲟⲩϩⲉ	sost_verb_asso
ϫⲡⲉ	sost_verb_nomisost_verb_nomi
ϫⲡⲓⲉ	sost_verb_nomi
ϫⲡⲓⲟ	sost_verb_pron
ϫⲡⲟ	sost_verb_assosost_verb_pron
ϫⲣⲟ	sost_verb_asso
ϫⲧⲟ	sost_verb_assosost_verb_pron
ϫⲱ	sost_egiz_pronsost_verb_asso
ϫⲱϩ	sost_verb_assosost_verb_asso
ϫⲱϩⲙ	sost_verb_asso
ϫⲱϭⲉ	sost_verb_asso
ϫⲱⲕ	sost_verb_asso
ϫⲱⲕⲉⲃⲟⲗ	sost_verb_asso
ϫⲱⲕⲙ	sost_verb_asso
ϫⲱⲕⲣ	sost_verb_asso
ϫⲱⲗϫ	sost_verb_asso
ϫⲱⲙⲙⲟⲟⲩ	sost_verb_asso
ϫⲱⲛⲧ	sost_verb_asso
ϫⲱⲣ	sost_verb_asso
ϫⲱⲣⲉⲙ	sost_verb_asso
ϫⲱⲣⲙ	sost_verb_asso
ϫⲱⲧⲉ	sost_verb_asso
ϫⲱⲱⲣⲉ	sost_verb_asso
ϭⲁⲗⲉ	sost_verb_nomi
ϭⲁⲗⲱⲱ	sost_verb_pron
ϭⲃⲃⲉ	sost_verb_asso
ϭⲉⲃ	sost_verb_nomi
ϭⲉⲃⲃⲉ	sost_verb_grec
ϭⲉⲗⲉ	sost_verb_nomi
ϭⲉⲗⲡ	sost_verb_nomi
ϭⲉⲛ	sost_verb_nomi
ϭⲉⲛⲑⲉⲛ	sost_verb_nomi
ϭⲉⲛⲧ	sost_verb_pron
ϭⲉⲡ	sost_verb_nomi
ϭⲉⲡⲏ	sost_verb_asso
ϭⲓⲛⲉ	sost_verb_asso
ϭⲓⲛⲉⲙⲡϣⲓⲛⲉ	sost_verb_asso
ϭⲗⲡ	sost_verb_nomi
ϭⲙ	sost_verb_nomi
ϭⲙϭⲟⲙ	sost_verb_asso
ϭⲙⲡϣⲓⲛⲉ	sost_verb_asso
ϭⲛ	sost_verb_nomi
ϭⲛⲁⲣⲓⲕⲉ	sost_verb_asso
ϭⲛⲑⲉⲙ	sost_verb_nomi
ϭⲛⲑⲉⲛ	sost_verb_nomi
ϭⲛⲟⲛ	sost_verb_asso
ϭⲛⲣⲁⲧ	sost_verb_pron
ϭⲛⲧ	sost_verb_pron
ϭⲟϫϭⲉϫ	sost_verb_asso
ϭⲟⲉⲓⲗⲉ	sost_verb_asso
ϭⲟⲓⲗⲉ	sost_verb_asso
ϭⲟⲗϫ	sost_verb_asso
ϭⲟⲗⲡ	sost_verb_pronqual
ϭⲟⲙϭⲉⲙ	sost_verb_asso
ϭⲟⲙϭⲙ	sost_verb_asso
ϭⲟⲟⲗⲉ	sost_verb_pronqual
ϭⲟⲡ	sost_verb_pron
ϭⲟⲣϣ	sost_verb_pron
ϭⲱ	sost_verb_asso
ϭⲱϣⲧ	sost_verb_asso
ϭⲱϫⲃ	sost_verb_asso
ϭⲱⲗⲡ	sost_verb_asso
ϭⲱⲟⲩ	sost_verb_asso
ϭⲱⲡⲉ	sost_verb_asso
ϭⲱⲡⲧ	sost_verb_asso
ϭⲱⲣϣ	sost_verb_asso
ϭⲱⲣϭ	sost_verb_asso
ϭⲱⲧϩ	sost_verb_asso
ϭⲱⲧⲡ	sost_verb_asso
ϭⲱⲧⲣ	sost_verb_asso
ϭⲱⲱⲃⲉ	sost_verb_asso
ϭⲱⲱⲙⲉ	sost_verb_asso
ϯ	refe_partrefe_dimonumesost_verb_assosost_verb_nomi
ϯϩⲉ	sost_verb_asso
ϯϩⲧⲏ	sost_verb_pron
ϯϭⲟⲙ	sost_verb_asso
ϯⲁⲕⲱⲛⲉⲓ	sost_verb_grec
ϯⲉⲓϥⲧ	sost_verb_asso
ϯⲉⲟⲟⲩ	sost_verb_asso
ϯⲑⲉ	sost_verb_asso
ϯⲗⲟⲅⲟⲥ	sost_verb_asso
ϯⲙⲡⲉϥⲟⲩⲟⲉⲓ	sost_verb_asso
ϯⲙⲡⲉϥⲟⲩⲟⲓ	sost_verb_asso
ϯⲙⲡⲉⲕⲟⲩⲟⲉⲓ	sost_verb_asso
ϯⲙⲡⲉⲕⲟⲩⲟⲓ	sost_verb_asso
ϯⲙⲡⲉⲛⲟⲩⲟⲉⲓ	sost_verb_asso
ϯⲙⲡⲉⲛⲟⲩⲟⲓ	sost_verb_asso
ϯⲙⲡⲉⲥⲟⲩⲟⲉⲓ	sost_verb_asso
ϯⲙⲡⲉⲥⲟⲩⲟⲓ	sost_verb_asso
ϯⲙⲡⲉⲩⲟⲩⲟⲉⲓ	sost_verb_asso
ϯⲙⲡⲉⲩⲟⲩⲟⲓ	sost_verb_asso
ϯⲙⲧⲟⲛ	sost_verb_asso
ϯⲛⲁⲁⲕⲉ	sost_verb_asso
ϯⲛⲟⲩϭⲥ	sost_verb_asso
ϯⲟⲩⲃⲉ	sost_verb_nomi
ϯⲟⲩⲟⲉⲓ	sost_verb_asso
ϯⲟⲩⲟⲓ	sost_verb_asso
ϯⲟⲩⲱ	sost_verb_asso
ϯⲡⲁⲟⲩⲟⲓ	sost_verb_asso
ϯⲡⲓ	sost_verb_asso
ϯⲣⲁⲛ	sost_verb_asso
ϯⲥⲃⲱ	sost_verb_asso
ϯⲥⲟ	sost_verb_asso
ϯⲧⲟⲟⲧ	sost_verb_pron
ϯⲧⲟⲟⲧⲟⲩ	sost_verb_pron
ϯⲱⲛϩ	sost_verb_asso
ⲁϣⲧ	sost_verb_pron
ⲁϩⲉ	sost_verb_asso
ⲁϩⲉⲣⲁⲧ	sost_verb_pron
ⲁⲁ	sost_verb_pron
ⲁⲁϥ	sost_verb_pron
ⲁⲅⲱⲛⲓⲍⲉ	sost_verb_grec
ⲁⲇⲓⲕⲉⲓ	sost_verb_grec
ⲁⲑⲉⲧⲉⲓ	sost_verb_grec
ⲁⲓⲥⲑⲁⲛⲉ	sost_verb_grec
ⲁⲓⲧⲉⲓ	sost_verb_grec
ⲁⲓⲭⲙⲁⲗⲟⲧⲓⲍⲉ	sost_verb_grec
ⲁⲓⲭⲙⲁⲗⲱⲧⲓⲍⲉ	sost_verb_grec
ⲁⲕⲁⲛⲁⲕⲧⲓ	sost_verb_grec
ⲁⲗⲉ	sost_verb_asso
ⲁⲗⲗⲏⲅⲟⲣⲉⲓ	sost_verb_grec
ⲁⲙⲁϩⲧⲉ	sost_verb_asso
ⲁⲙⲉⲗⲉⲓ	sost_verb_grec
ⲁⲙⲉⲗⲓ	sost_verb_grec
ⲁⲙⲫⲓⲁⲍⲉ	sost_verb_grec
ⲁⲛϩⲁⲗⲓⲥⲕⲉ	sost_verb_grec
ⲁⲛⲁⲅⲕⲁⲍⲉ	sost_verb_grec
ⲁⲛⲁⲑⲉⲙⲁⲧⲓⲍⲉ	sost_verb_grec
ⲁⲛⲁⲕⲁⲗⲉⲓ	sost_verb_grec
ⲁⲛⲁⲛⲉⲩⲉ	sost_verb_grec
ⲁⲛⲁⲥⲧⲣⲉⲫⲩ	sost_verb_grec
ⲁⲛⲁⲭⲟⲣⲉⲓ	sost_verb_grec
ⲁⲛⲁⲭⲱⲣⲉⲓ	sost_verb_grec
ⲁⲛⲁⲭⲱⲣⲓ	sost_verb_grec
ⲁⲛⲉⲭⲉ	sost_verb_grec
ⲁⲛⲓⲭⲉ	sost_verb_grec
ⲁⲛⲧⲓⲗⲉⲅⲉ	sost_verb_grec
ⲁⲝⲓⲟⲩ	sost_verb_grec
ⲁⲡⲁⲅⲅⲉⲓⲗⲉ	sost_verb_grec
ⲁⲡⲁⲓⲧⲉⲓ	sost_verb_grec
ⲁⲡⲁⲛⲧⲁ	sost_verb_grec
ⲁⲡⲁⲧⲁ	sost_verb_grec
ⲁⲡⲟⲇⲏⲙⲉⲓ	sost_verb_grec
ⲁⲡⲟⲕⲁⲑⲓⲥⲧⲁ	sost_verb_grec
ⲁⲡⲟⲕⲟⲗⲗⲁ	sost_verb_grec
ⲁⲡⲟⲕⲣⲓⲛⲉⲥⲑⲁⲓ	sost_verb_grec
ⲁⲡⲟⲗⲁⲩⲉ	sost_verb_grec
ⲁⲡⲟⲗⲟⲅⲓⲍⲉ	sost_verb_grec
ⲁⲡⲟⲥⲧⲏⲑⲓⲍⲉ	sost_verb_grec
ⲁⲡⲟⲧⲁⲥⲥⲉ	sost_verb_grec
ⲁⲣⲉⲥⲕⲉ	sost_verb_grec
ⲁⲣⲓⲥⲧⲁ	sost_verb_grec
ⲁⲣⲛⲁ	sost_verb_grec
ⲁⲣⲭⲉⲓ	sost_verb_grec
ⲁⲣⲭⲉⲥⲑⲁⲓ	sost_verb_grec
ⲁⲣⲭⲓⲥⲑⲁⲓ	sost_verb_grec
ⲁⲥⲕⲉⲓ	sost_verb_grec
ⲁⲥⲡⲁⲍⲉ	sost_verb_grec
ⲁⲥⲫⲁⲗⲓⲍⲉ	sost_verb_grec
ⲁⲥⲭⲏⲙⲟⲛⲉⲓ	sost_verb_grec
ⲁⲧⲟⲛⲉⲓ	sost_verb_grec
ⲁⲩⲕⲟⲩⲥⲧⲟⲥ	sost_verb_grec
ⲁⲩⲝⲁⲛⲉ	sost_verb_grec
ⲃⲁⲃⲱⲱ	sost_verb_pron
ⲃⲁⲡⲧⲓⲍⲉ	sost_verb_grec
ⲃⲁⲡⲧⲓⲍⲉⲛ	sost_verb_grec
ⲃⲉⲃⲉ	sost_verb_asso
ⲃⲉⲗ	sost_verb_nomi
ⲃⲉⲧ	sost_verb_nomi
ⲃⲗⲁⲡⲧⲉⲓ	sost_verb_grec
ⲃⲟϣ	sost_verb_pron
ⲃⲟϭ	sost_verb_pron
ⲃⲟⲏⲑⲉⲓ	sost_verb_grec
ⲃⲟⲗ	sost_asso_egiz_masc_siplsost_verb_pron
ⲃⲟⲟⲣ	sost_verb_pron
ⲃⲟⲧ	sost_verb_pron
ⲃⲣⲃⲣ	sost_verb_asso
ⲃⲱϣ	sost_verb_asso
ⲃⲱⲕ	sost_verb_assosost_verb_asso
ⲃⲱⲗ	sost_verb_asso
ⲃⲱⲱⲣⲉ	sost_verb_asso
ⲅⲩⲙⲛⲁⲍⲉ	sost_verb_grec
ⲇⲉⲓⲡⲛⲉⲩⲉ	sost_verb_grec
ⲇⲏⲗⲟⲩ	sost_verb_grec
ⲇⲏⲙⲏⲅⲟⲣⲉⲓ	sost_verb_grec
ⲇⲓⲁⲇⲉⲭⲉ	sost_verb_grec
ⲇⲓⲁⲕⲟⲛⲉⲓ	sost_verb_grec
ⲇⲓⲁⲕⲟⲛⲓ
ⲇⲓⲁⲕⲣⲓⲛⲉ	sost_verb_grec
ⲇⲓⲁⲗⲉⲅⲉ	sost_verb_grec
ⲇⲓⲁⲡⲉⲣⲁ	sost_verb_grec
ⲇⲓⲇⲁⲥⲕⲉ	sost_verb_grec
ⲇⲓⲇⲁⲥⲕⲉⲓ	sost_verb_grec
ⲇⲓⲟⲓⲕⲉⲓ	sost_verb_grec
ⲇⲓⲟⲣⲑⲟⲩ	sost_verb_grec
ⲇⲓⲡⲛⲉⲩⲉ	sost_verb_grec
ⲇⲓⲱⲕⲉ	sost_verb_grec
ⲇⲓⲱⲕⲉⲓ	sost_verb_grec
ⲇⲟⲅⲙⲁⲧⲓⲍⲉ	sost_verb_grec
ⲇⲟⲕⲉⲓ	sost_verb_grec
ⲇⲟⲕⲓⲙⲁⲍⲉ	sost_verb_grec
ⲉϣ	sost_verb_nomi
ⲉϣϣⲉ	verb_imps
ⲉϣⲗⲟⲩⲗⲁⲓ	sost_verb_asso
ⲉϣⲧ	sost_verb_nomi
ⲉϥⲧ	sost_verb_nomi
ⲉϫ	sost_verb_asso
ⲉⲅⲅⲟⲙⲓⲁⲍⲉ	sost_verb_grec
ⲉⲅⲅⲱⲙⲓⲁⲍⲉ	sost_verb_grec
ⲉⲅⲕⲁⲕⲉⲓ	sost_verb_grec
ⲉⲅⲕⲁⲕⲓ	sost_verb_grec
ⲉⲅⲕⲟⲙⲓⲁⲍⲉ	sost_verb_grec
ⲉⲅⲕⲣⲁⲧⲉⲩⲉ	sost_verb_grec
ⲉⲅⲕⲱⲙⲓⲁⲍⲉ	sost_verb_grec
ⲉⲓ	refe_partsost_verb_asso
ⲉⲓϣⲉ	sost_verb_asso
ⲉⲓⲁⲧⲟⲟⲧ	sost_verb_pron
ⲉⲓⲃⲉ	sost_verb_asso
ⲉⲓⲉϩⲣⲁⲓ	sost_verb_asso
ⲉⲓⲙⲉ	sost_verb_asso
ⲉⲓⲛⲉ	sost_verb_asso
ⲉⲓⲣⲉ	sost_verb_asso
ⲉⲓⲱⲣϩ	sost_verb_asso
ⲉⲓⲱⲣⲙ	sost_verb_asso
ⲉⲗϩⲏⲙ	sost_verb_asso
ⲉⲗϩⲱⲃ	sost_verb_asso
ⲉⲗⲉⲅⲭⲉ	sost_verb_grec
ⲉⲙ	sost_verb_asso
ⲉⲙⲙⲁⲛⲟⲩⲏⲗ	sost_verb_grec
ⲉⲙⲡϣⲁ	sost_verb_asso
ⲉⲙⲧⲟⲛ	sost_verb_asso
ⲉⲛⲅⲟⲙⲓⲁⲍⲉ	sost_verb_grec
ⲉⲛⲅⲱⲙⲓⲁⲍⲉ	sost_verb_grec
ⲉⲛⲉⲣⲅⲉⲓ	sost_verb_grec
ⲉⲛⲕⲟⲙⲓⲁⲍⲉ	sost_verb_grec
ⲉⲛⲕⲟⲧⲕ	sost_verb_asso
ⲉⲛⲕⲱⲙⲓⲁⲍⲉ	sost_verb_grec
ⲉⲛⲟⲭⲗⲉⲓ	sost_verb_grec
ⲉⲛⲱⲭⲗⲉⲓ
ⲉⲝⲁⲡⲁⲧⲁ	sost_verb_grec
ⲉⲝⲉⲥⲧⲁⲓ	verb_grec
ⲉⲝⲉⲥⲧⲉⲓ	verb_grec
ⲉⲝⲉⲥⲧⲓ	verb_grec
ⲉⲝⲉⲧⲁⲍⲉ	sost_verb_grec
ⲉⲝⲉⲫⲣⲁⲥⲉ	sost_verb_grec
ⲉⲝⲏⲅⲉⲓ	sost_verb_grec
ⲉⲝⲏⲅⲉⲓⲥⲑⲁⲓ	sost_verb_grec
ⲉⲝⲟⲙⲟⲗⲟⲅⲉⲓ	sost_verb_grec
ⲉⲝⲟⲙⲟⲗⲟⲅⲓ
ⲉⲝⲟⲙⲟⲗⲱⲅⲉⲓ	sost_verb_grec
ⲉⲝⲟⲙⲱⲗⲟⲅⲉⲓ	sost_verb_grec
ⲉⲝⲟⲙⲱⲗⲱⲅⲉⲓ	sost_verb_grec
ⲉⲝⲟⲣⲓⲍⲉ	sost_verb_grec
ⲉⲝⲱⲙⲟⲗⲟⲅⲉⲓ	sost_verb_grec
ⲉⲝⲱⲙⲟⲗⲱⲅⲉⲓ	sost_verb_grec
ⲉⲝⲱⲙⲱⲗⲟⲅⲉⲓ	sost_verb_grec
ⲉⲝⲱⲙⲱⲗⲱⲅⲉⲓ	sost_verb_grec
ⲉⲡ
ⲉⲡⲁⲓⲛⲟⲩ	sost_verb_grec
ⲉⲡⲉⲑⲩⲙⲉⲓ	sost_verb_grec
ⲉⲡⲉⲓⲕⲁⲗⲉⲓ	sost_verb_grec
ⲉⲡⲉⲓⲥⲧⲏⲙⲉⲓ	sost_verb_grec
ⲉⲡⲓⲃⲟⲩⲗⲉⲩⲉ	sost_verb_grec
ⲉⲡⲓⲑⲩⲙⲉⲓ	sost_verb_grec
ⲉⲡⲓⲕⲁⲗⲉⲓ	sost_verb_grec
ⲉⲡⲓⲕⲁⲗⲓ	sost_verb_grec
ⲉⲡⲓⲥⲧⲏⲙⲉⲓ	sost_verb_grec
ⲉⲡⲓⲧⲁⲥⲥⲉ	sost_verb_grec
ⲉⲡⲓⲧⲓⲙⲁ	sost_verb_grec
ⲉⲡⲓⲭⲉⲓⲣⲉⲓ	sost_verb_grec
ⲉⲣ	sost_verb_nomi
ⲉⲣϣⲙⲙⲟ	sost_verb_asso
ⲉⲣϣⲡⲏⲣⲉ	sost_verb_asso
ⲉⲣϥⲛⲧ	sost_verb_asso
ⲉⲣϩⲛⲁ	sost_verb_pron
ⲉⲣϩⲟⲧⲉ	sost_verb_asso
ⲉⲣⲁⲛⲁ	sost_verb_pron
ⲉⲣⲁⲛⲁⲓ	sost_verb_pron
ⲉⲣⲃ	sost_verb_nomi
ⲉⲣⲏⲧ	sost_verb_asso
ⲉⲣⲙⲛⲧⲣⲉ	sost_verb_asso
ⲉⲣⲛⲟⲃⲉ	sost_verb_asso
ⲉⲣⲡⲃⲟⲗ	sost_verb_asso
ⲉⲩⲉⲣⲅⲉⲧⲉⲓ	sost_verb_grec
ⲉⲩⲡⲟⲣⲉⲓ	sost_verb_grec
ⲉⲩⲧⲏⲗⲓⲟⲩ	sost_verb_grec
ⲉⲩⲫⲣⲁⲛⲉ	sost_verb_grec
ⲉⲩⲭⲁⲣⲓⲍⲉ	sost_verb_grec
ⲉⲩⲭⲁⲣⲓⲥⲧⲉⲓ	sost_verb_grec
ⲉⲩⲭⲁⲣⲓⲥⲧⲓ	sost_verb_grec
ⲉⲩⲭⲁⲣⲓⲥⲧⲟⲩ	sost_verb_grec
ⲍⲱⲅⲣⲁⲫⲓ	sost_verb_grec
ⲏⲥⲩⲭⲁⲍⲉ	sost_verb_grec
ⲑⲁⲗⲡⲉⲓ	sost_verb_grec
ⲑⲁⲣⲉⲓ	sost_verb_grec
ⲑⲁⲣⲣⲉⲓ	sost_verb_grec
ⲑⲁⲩⲙⲁⲍⲉ	sost_verb_grec
ⲑⲃⲃⲓⲉ	sost_verb_nomi
ⲑⲃⲃⲓⲟ	sost_verb_asso
ⲑⲉⲟⲣⲉⲓ	sost_verb_grec
ⲑⲉⲣⲁⲡⲉⲩⲉ	sost_verb_grec
ⲑⲉⲱⲣⲉⲓ	sost_verb_grec
ⲑⲉⲱⲣⲓ	sost_verb_grec
ⲑⲏⲣⲁⲡⲉⲩⲉ	sost_verb_grec
ⲑⲗⲓⲃⲉ	sost_verb_grec
ⲑⲙⲕⲉ	sost_verb_nomi
ⲑⲙⲕⲟ	sost_verb_assosost_verb_pron
ⲑⲙⲥⲟ	sost_verb_assosost_verb_pron
ⲑⲟ	sost_verb_asso
ⲑⲡⲟ	sost_verb_pron
ⲑⲣϣⲟ	sost_verb_assosost_verb_pron
ⲑⲩⲥⲓⲁⲍⲉ	sost_verb_grec
ⲓ	refe_partsost_verb_asso
ⲓⲃⲉ	sost_verb_asso
ⲓⲣⲉ	sost_verb_asso
ⲓⲱⲁⲕⲓⲙ	sost_verb_grec
ⲕⲁ	sost_verb_nomi
ⲕⲁϩⲕϩ	sost_verb_asso
ⲕⲁϩⲕⲉϩ	sost_verb_asso
ⲕⲁϩⲧⲏ	sost_verb_pron
ⲕⲁϯⲭⲉ	sost_verb_grec
ⲕⲁⲁ	sost_verb_pron
ⲕⲁⲑⲁⲣⲓⲍⲉ	sost_verb_grec
ⲕⲁⲑⲏⲅⲉⲓ	sost_verb_grec
ⲕⲁⲑⲏⲕⲉⲓ	sost_verb_grec
ⲕⲁⲑⲓⲥⲧⲁ	sost_verb_grec
ⲕⲁⲗⲉⲓ	sost_verb_grec
ⲕⲁⲙⲁ	sost_verb_asso
ⲕⲁⲡⲏⲗⲉⲩⲉ	sost_verb_grec
ⲕⲁⲣⲁⲧ	sost_verb_pron
ⲕⲁⲣⲱ	sost_verb_pron
ⲕⲁⲥⲕⲉⲥ	sost_verb_asso
ⲕⲁⲥⲕⲥ	sost_verb_asso
ⲕⲁⲧⲁⲇⲓⲕⲁⲍⲉ	sost_verb_grec
ⲕⲁⲧⲁⲗⲁⲗⲉⲓ	sost_verb_grec
ⲕⲁⲧⲁⲗⲩ	sost_verb_grec
ⲕⲁⲧⲁⲛⲟⲉⲓ	sost_verb_grec
ⲕⲁⲧⲁⲛⲟⲓ	sost_verb_grec
ⲕⲁⲧⲁⲛⲧⲁ	sost_verb_grec
ⲕⲁⲧⲁⲡⲟⲛⲧⲓⲍⲉ	sost_verb_grec
ⲕⲁⲧⲁⲡⲱⲛⲧⲓⲍⲉ	sost_verb_grec
ⲕⲁⲧⲁⲣⲅⲉⲓ	sost_verb_grec
ⲕⲁⲧⲁⲥⲧⲣⲉⲫⲉ	sost_verb_grec
ⲕⲁⲧⲁⲥⲧⲩⲗⲉ	sost_verb_grec
ⲕⲁⲧⲁⲫⲣⲟⲛⲉⲓ	sost_verb_grec
ⲕⲁⲧⲉⲭⲉ	sost_verb_grec
ⲕⲁⲧⲏⲅⲟⲣⲉⲓ	sost_verb_grec
ⲕⲁⲧⲏⲭⲉⲓ	sost_verb_grec
ⲕⲁⲧⲓⲭⲉ	sost_verb_grec
ⲕⲁⲧⲟⲟⲧ	sost_verb_nomi
ⲕⲃⲟ	sost_verb_asso
ⲕⲉⲃⲉⲣⲛⲁ	sost_verb_grec
ⲕⲉⲗⲉⲩⲉ	sost_verb_grec
ⲕⲉⲣⲉ	sost_verb_asso
ⲕⲉⲧ	sost_asso_egiz_masc_singsost_verb_nomi
ⲕⲏⲣⲓⲥⲥⲉ	sost_verb_grec
ⲕⲏⲣⲩⲥⲥⲉ	sost_verb_grec
ⲕⲓⲙ	sost_verb_asso
ⲕⲓⲛⲇⲏⲛⲉⲩⲉ	sost_verb_grec
ⲕⲗⲉⲟⲡⲁ	sost_verb_grec
ⲕⲗⲉⲱⲡⲁ	sost_verb_grec
ⲕⲗⲏⲣⲟⲛⲟⲙⲉⲓ	sost_verb_grec
ⲕⲗⲏⲣⲟⲩ	sost_verb_grec
ⲕⲗⲩⲣⲟⲛⲟⲙⲉⲓ	sost_verb_grec
ⲕⲛⲛⲉ	sost_verb_asso
ⲕⲟⲓⲛⲟⲛⲉⲓ	sost_verb_grec
ⲕⲟⲓⲛⲱⲛⲉⲓ	sost_verb_grec
ⲕⲟⲗϫ	sost_verb_asso
ⲕⲟⲗⲁⲍⲉ	sost_verb_grec
ⲕⲟⲗⲏ	sost_verb_grec
ⲕⲟⲗⲓ	sost_verb_grec
ⲕⲟⲗⲓⲉ	sost_verb_grec
ⲕⲟⲗⲩ	sost_verb_grec
ⲕⲟⲗⲩⲉ	sost_verb_grec
ⲕⲟⲙϣ	sost_verb_pron
ⲕⲟⲛⲥ	sost_verb_pron
ⲕⲟⲟⲛⲥ	sost_verb_pron
ⲕⲟⲟⲥ	sost_verb_pron
ⲕⲟⲥⲕⲉⲥ	sost_verb_asso
ⲕⲟⲥⲕⲥ	sost_verb_asso
ⲕⲟⲥⲙⲉⲓ	sost_verb_grec
ⲕⲟⲧ	sost_asso_egiz_masc_siplsost_verb_pron
ⲕⲣⲁⲛⲓⲟⲛ	sost_verb_grec
ⲕⲣⲓⲛⲉ	sost_verb_grec
ⲕⲣⲟⲙⲣⲉⲙ	sost_verb_asso
ⲕⲣⲟⲙⲣⲙ	sost_verb_asso
ⲕⲧⲉ	sost_verb_nomi
ⲕⲧⲟ	sost_verb_assosost_verb_pron
ⲕⲧⲟⲛ	sost_verb_pron
ⲕⲩⲃⲉⲣⲛⲁ	sost_verb_grec
ⲕⲩⲃⲉⲣⲛⲏⲧⲉⲩⲉ	sost_verb_grec
ⲕⲩⲣⲏⲥⲥⲉ	sost_verb_grec
ⲕⲩⲣⲓⲥⲥⲉ	sost_verb_grec
ⲕⲩⲣⲩⲥⲥⲉ	sost_verb_grec
ⲕⲱ	sost_verb_asso
ⲕⲱϩ	sost_verb_asso
ⲕⲱⲃ	sost_verb_asso
ⲕⲱⲗϩ	sost_verb_asso
ⲕⲱⲗϫ	sost_verb_asso
ⲕⲱⲗⲉ	sost_verb_grec
ⲕⲱⲗⲉⲓ	sost_verb_grec
ⲕⲱⲗⲏ	sost_verb_grec
ⲕⲱⲗⲓ	sost_verb_grec
ⲕⲱⲗⲓⲉ	sost_verb_grec
ⲕⲱⲗⲡ	sost_verb_asso
ⲕⲱⲗⲩ	sost_verb_grec
ⲕⲱⲗⲩⲉ	sost_verb_grec
ⲕⲱⲙϣ	sost_verb_asso
ⲕⲱⲛϩⲧⲏ	sost_verb_pron
ⲕⲱⲛⲣⲱ	sost_verb_pron
ⲕⲱⲛⲥ	sost_verb_asso
ⲕⲱⲛⲥⲱ	sost_verb_pron
ⲕⲱⲣϣ	sost_verb_asso
ⲕⲱⲣⲉϣ	sost_verb_asso
ⲕⲱⲧ	sost_verb_asso
ⲕⲱⲧⲉ	sost_verb_asso
ⲕⲱⲱⲃⲉ	sost_verb_asso
ⲕⲱⲱⲗⲉ	sost_verb_asso
ⲕⲱⲱⲛⲥ	sost_verb_asso
ⲕⲱⲱⲣⲉ	sost_verb_asso
ⲕⲱⲱⲥ	sost_verb_asso
ⲗϩⲏⲙ	sost_verb_asso
ⲗϩⲱⲃ	sost_verb_asso
ⲗⲁⲙⲡⲉⲩⲉ	sost_verb_grec
ⲗⲉⲓⲧⲟⲩⲣⲅⲉⲓ	sost_verb_grec
ⲗⲏⲡⲉ	sost_verb_grec
ⲗⲏⲡⲉⲓ	sost_verb_grec
ⲗⲓⲃⲉ	sost_verb_asso
ⲗⲓⲧⲟⲩⲣⲅⲉⲓ	sost_verb_grec
ⲗⲟ	sost_verb_assosost_verb_asso
ⲗⲟϥⲗϥ	sost_verb_asso
ⲗⲟϥⲗⲉϥ	sost_verb_asso
ⲗⲟϫϩ	sost_verb_asso
ⲗⲟϫⲗϫ	sost_verb_asso
ⲗⲟϫⲗⲉϫ	sost_verb_asso
ⲗⲟⲅⲓⲍⲉ	sost_verb_grec
ⲗⲟⲅⲭⲓⲍⲉ	sost_verb_grec
ⲗⲟⲕⲥ	sost_verb_pronqual
ⲗⲟⲩⲗⲁⲓ	sost_verb_asso
ⲗⲩⲡⲉⲓ	sost_verb_grec
ⲗⲩⲡⲏ	sost_verb_grec
ⲗⲱϩⲉⲙ	sost_verb_asso
ⲗⲱϩⲙ	sost_verb_asso
ⲗⲱϭϫ	sost_verb_asso
ⲗⲱϭⲉ	sost_verb_asso
ⲗⲱⲃϣ	sost_verb_asso
ⲗⲱⲕⲥ	sost_verb_asso
ⲗⲱⲙⲉⲥ	sost_verb_asso
ⲗⲱⲙⲥ	sost_verb_asso
ⲗⲱⲱⲙ	sost_verb_asso
ⲗⲱⲱⲙⲉ	sost_verb_asso
ⲙϣⲁ	sost_verb_asso
ⲙⲁϩ	sost_verb_pron
ⲙⲁⲧⲉ	sost_verb_asso
ⲙⲉ	triptripsost_asso_egiz_femm_siplsost_verb_asso
ⲙⲉϣϣⲉ	sost_verb_asso
ⲙⲉϣⲧ	sost_verb_nomi
ⲙⲉϩ	adnusost_verb_nomiqual
ⲙⲉϩⲣⲱ	sost_verb_pron
ⲙⲉⲉⲩⲉ	sost_verb_asso
ⲙⲉⲕⲙⲟⲩⲕ	sost_verb_pron
ⲙⲉⲗⲉⲧⲁ	sost_verb_grec
ⲙⲉⲣ	sost_verb_nomi
ⲙⲉⲣⲉ	trip
ⲙⲉⲥⲧⲉ	sost_verb_nomi
ⲙⲉⲥⲧⲱ	sost_verb_pron
ⲙⲉⲧⲁⲛⲟⲉⲓ	sost_verb_grec
ⲙⲉⲧⲁⲛⲟⲓ	sost_verb_grec
ⲙⲉⲧⲉⲭⲉ	sost_verb_grec
ⲙⲉⲩⲉ	sost_verb_asso
ⲙⲉⲩⲧ	sost_verb_nomi
ⲙⲏⲛⲉⲩⲉ	sost_verb_grec
ⲙⲓϣⲉ	sost_verb_asso
ⲙⲓⲥⲉ	sost_verb_asso
ⲙⲕⲁϩ	sost_verb_asso
ⲙⲕⲁϩⲛϩⲏⲧ	sost_verb_asso
ⲙⲕⲙⲟⲩⲕ	sost_verb_pron
ⲙⲕⲙⲟⲩⲕⲉ	sost_verb_pron
ⲙⲟϫϭ	sost_verb_pronqual
ⲙⲟⲕϩⲛϩⲏⲧ	sost_verb_asso
ⲙⲟⲕⲉϩⲛϩⲏⲧ	sost_verb_asso
ⲙⲟⲕⲙⲉⲕ	sost_verb_asso
ⲙⲟⲕⲙⲕ	sost_verb_asso
ⲙⲟⲗϩ	sost_verb_pronqual
ⲙⲟⲟϣⲉ	sost_verb_asso
ⲙⲟⲟⲛⲉ	sost_verb_asso
ⲙⲟⲟⲩⲧ	sost_verb_pronqual
ⲙⲟⲣ	sost_verb_pron
ⲙⲟⲥⲧⲉ	sost_verb_asso
ⲙⲟⲩ	sost_verb_asso
ⲙⲟⲩϣⲧ	sost_verb_asso
ⲙⲟⲩϩ	sost_verb_assosost_verb_asso
ⲙⲟⲩⲕϩ	sost_verb_asso
ⲙⲟⲩⲗϩ	sost_verb_asso
ⲙⲟⲩⲟⲩⲧ	sost_verb_asso
ⲙⲟⲩⲣ	sost_verb_asso
ⲙⲟⲩⲧⲉ	sost_verb_asso
ⲙⲡϣⲁ	sost_verb_asso
ⲙⲧⲟⲛ	sost_verb_asso
ⲛ	refe_partrefe_dimo_artinegatripconvprep_nomi_egizattrsost_verb_nomisost_verb_pron
ⲛϩⲟⲩⲧ	sost_verb_asso
ⲛⲁ	refe_dimo_possrefe_dimo_pronfutuprep_pron_egizsost_verb_asso
ⲛⲁϩⲙ	sost_verb_pron
ⲛⲁϩⲙⲉ	sost_verb_pron
ⲛⲁϩⲙⲟⲩ	sost_verb_pron
ⲛⲁϩⲧ	sost_verb_pron
ⲛⲁϩⲧⲉ	sost_verb_asso
ⲛⲁⲩ	sost_asso_egiz_masc_siplsost_verb_asso
ⲛⲉϩ	sost_asso_egiz_masc_siplsost_verb_nomi
ⲛⲉϩϣⲗϥ	sost_verb_asso
ⲛⲉϩⲉⲙ	sost_verb_nomi
ⲛⲉϩⲙ	sost_verb_nomi
ⲛⲉϩⲡⲉ	sost_verb_asso
ⲛⲉϩⲥⲉ	sost_verb_asso
ⲛⲉϫ	sost_verb_nomi
ⲛⲉϭⲛⲟϭ	sost_verb_pron
ⲛⲉϭⲛⲟⲩϭ	sost_verb_asso
ⲛⲉⲥⲧⲉⲟⲩⲉ	sost_verb_grec
ⲛⲉⲥⲧⲉⲩⲉ	sost_verb_grec
ⲛⲏⲥⲧⲉⲟⲩⲉ	sost_verb_grec
ⲛⲏⲥⲧⲉⲩⲉ	sost_verb_grec
ⲛⲏⲫⲉ	sost_verb_grec
ⲛⲓϥⲉ	sost_verb_asso
ⲛⲓⲃⲉ	sost_verb_asso
ⲛⲓⲥⲉ	sost_verb_asso
ⲛⲕⲟⲧⲕ	sost_verb_asso
ⲛⲟϣⲡ	sost_verb_pron
ⲛⲟϫ	sost_verb_pron
ⲛⲟϭⲛϭ	sost_verb_asso
ⲛⲟϭⲛⲉϭ	sost_verb_asso
ⲛⲟⲉⲓ	sost_verb_grec
ⲛⲟⲉⲓⲛ	sost_verb_asso
ⲛⲟⲓ	sost_verb_grec
ⲛⲟⲩ	refe_dimo_posssost_verb_asso
ⲛⲟⲩϣⲡ	sost_verb_asso
ⲛⲟⲩϣⲥ	sost_verb_asso
ⲛⲟⲩϩⲉ	sost_verb_nomi
ⲛⲟⲩϩⲙ	sost_verb_asso
ⲛⲟⲩϫ	sost_verb_asso
ⲛⲟⲩϫⲉ	sost_verb_asso
ⲛⲟⲩϭⲥ	sost_verb_asso
ⲛⲟⲩⲃⲧ	sost_verb_asso
ⲛⲟⲩⲉ	sost_verb_asso
ⲛⲧ	convsost_verb_pron
ⲛⲧϥ	sost_verb_pron
ⲟϣ	sost_verb_pronqual
ⲟϣϥ	sost_verb_pron
ⲟϣⲙ	sost_verb_pron
ⲟϣⲟⲩ	sost_verb_pron
ⲟϩⲥ	sost_verb_pron
ⲟϭⲧϥ	sost_verb_pron
ⲟⲃϣ	sost_verb_pron
ⲟⲓⲕⲟⲛⲟⲙⲉⲓ	sost_verb_grec
ⲟⲗ	sost_verb_pron
ⲟⲙⲕ	sost_verb_pron
ⲟⲙⲥ	sost_verb_pron
ⲟⲙⲥⲟ	sost_verb_pron
ⲟⲛⲟⲙⲁⲍⲉ	sost_verb_grec
ⲟⲡⲧ	sost_verb_pron
ⲟⲣϫ	sost_verb_pronqual
ⲟⲣⲃⲉ	sost_verb_pron
ⲟⲧⲡⲉⲛ	sost_verb_pron
ⲟⲩϫⲁⲓ	sost_verb_asso
ⲟⲩⲁϣ	sost_verb_pron
ⲟⲩⲁϣⲟⲩ	sost_verb_pron
ⲟⲩⲁϩ	sost_verb_pron
ⲟⲩⲁϩⲕⲥϥⲛ	sost_verb_pron
ⲟⲩⲁⲗⲉⲛϯⲛⲟⲥ	sost_verb_grec
ⲟⲩⲃⲁϣ	sost_verb_asso
ⲟⲩⲉ	sost_verb_asso
ⲟⲩⲉϣ	sost_verb_nomi
ⲟⲩⲉϣⲥ	sost_verb_nomi
ⲟⲩⲉϩ
ⲟⲩⲉϩⲥⲁϩⲛⲉ	sost_verb_asso
ⲟⲩⲉⲓⲛⲉ	sost_verb_asso
ⲟⲩⲉⲙ	sost_verb_nomi
ⲟⲩⲉⲛ	sost_verb_nomi
ⲟⲩⲉⲛϩ	sost_verb_nomi
ⲟⲩⲕⲉⲝⲉⲥⲧⲉⲓ	verb_grec
ⲟⲩⲕⲉⲝⲉⲥⲧⲓ	verb_grec
ⲟⲩⲛⲟϥ	sost_verb_asso
ⲟⲩⲟϣⲃ	sost_verb_pron
ⲟⲩⲟϣⲃⲉ	sost_verb_pron
ⲟⲩⲟϩ	sost_verb_pron
ⲟⲩⲟⲗⲥ	sost_verb_pron
ⲟⲩⲟⲙ	sost_verb_pron
ⲟⲩⲟⲛϩ	sost_verb_pronqual
ⲟⲩⲟⲧⲟⲩⲉⲓⲧ	sost_verb_asso
ⲟⲩⲟⲧⲟⲩⲉⲧ	sost_verb_asso
ⲟⲩⲣⲟⲧ	sost_verb_asso
ⲟⲩⲱ	sost_verb_asso
ⲟⲩⲱϣ	sost_verb_asso
ⲟⲩⲱϣϥ	sost_verb_asso
ⲟⲩⲱϣⲃ	sost_verb_asso
ⲟⲩⲱϣⲥ	sost_verb_asso
ⲟⲩⲱϣⲧ	sost_verb_asso
ⲟⲩⲱϩ	sost_verb_asso
ⲟⲩⲱϩⲙ	sost_verb_asso
ⲟⲩⲱϭⲡ	sost_verb_asso
ⲟⲩⲱⲗⲉ	sost_verb_asso
ⲟⲩⲱⲗⲥ	sost_verb_asso
ⲟⲩⲱⲙ	sost_verb_asso
ⲟⲩⲱⲛ	sost_verb_asso
ⲟⲩⲱⲛϩ	sost_verb_asso
ⲟⲩⲱⲥϥ	sost_verb_asso
ⲟⲫⲉⲗⲉⲓ	sost_verb_grec
ⲡⲁϩ	sost_verb_pron
ⲡⲁϩⲧ	sost_verb_assosost_verb_pron
ⲡⲁⲓⲇⲉⲩⲉ	sost_verb_grec
ⲡⲁⲣϩⲓⲥⲧⲁ	sost_verb_grec
ⲡⲁⲣⲁⲃⲁ	sost_verb_grec
ⲡⲁⲣⲁⲃⲁⲗⲗⲉ	sost_verb_grec
ⲡⲁⲣⲁⲃⲁⲗⲗⲉⲓ	sost_verb_grec
ⲡⲁⲣⲁⲅⲅⲉⲓⲗⲉ	sost_verb_grec
ⲡⲁⲣⲁⲅⲅⲓⲗⲉ	sost_verb_grec
ⲡⲁⲣⲁⲅⲉ	sost_verb_grec
ⲡⲁⲣⲁⲇⲓⲅⲙⲁⲧⲓⲍⲉ	sost_verb_grec
ⲡⲁⲣⲁⲇⲓⲇⲟⲩ	sost_verb_grec
ⲡⲁⲣⲁⲕⲁⲗⲉⲓ	sost_verb_grec
ⲡⲁⲣⲁⲙⲩⲑⲓⲍⲉ	sost_verb_grec
ⲡⲁⲣⲁⲥⲕⲉⲩⲁⲍⲉ	sost_verb_grec
ⲡⲁⲣⲁⲧⲓⲅⲙⲁⲧⲓⲍⲉ	sost_verb_grec
ⲡⲁⲣⲁⲭⲱⲣⲉⲓ	sost_verb_grec
ⲡⲁⲣⲉⲗⲑⲉ	sost_verb_grec
ⲡⲁⲣⲣϩⲏⲥⲓⲁⲍⲉ	sost_verb_grec
ⲡⲁⲣⲣⲏⲥⲓⲁⲍⲉ	sost_verb_grec
ⲡⲁⲥⲧ	sost_verb_pron
ⲡⲁⲧⲁⲥⲥⲉ	sost_verb_grec
ⲡⲁⲧⲉⲓ	sost_verb_grec
ⲡⲉϣ	sost_verb_nomi
ⲡⲉϣⲛ	sost_verb_nomi
ⲡⲉϣⲥ	sost_verb_nomi
ⲡⲉϩⲧ	sost_verb_nomi
ⲡⲉⲇⲉⲩⲉ	sost_verb_grec
ⲡⲉⲓⲑⲉ	sost_verb_grec
ⲡⲉⲓⲣⲁⲍⲉ	sost_verb_grec
ⲡⲉⲓⲣⲉ	sost_verb_asso
ⲡⲉⲡⲧⲉⲓ	sost_verb_grec
ⲡⲉⲣϫ	sost_verb_nomi
ⲡⲉⲣⲁ	sost_verb_grec
ⲡⲉⲣⲉ	sost_verb_nomi
#ⲡⲉⲧⲉⲩⲉ
ⲡⲓⲑⲉ	sost_verb_grec
ⲡⲓⲗⲁⲧⲟⲥ	sost_verb_grec
ⲡⲓⲣⲁⲍⲉ	sost_verb_grec
ⲡⲓⲣⲉ	sost_verb_asso
ⲡⲓⲥⲧⲉⲩⲉ	sost_verb_grec
ⲡⲗⲁⲛⲁ	sost_verb_grec
ⲡⲗⲁⲥⲥⲉ	sost_verb_grec
ⲡⲗⲉⲟⲛⲉⲕⲧⲉⲓ	sost_verb_grec
ⲡⲗⲏⲣⲟⲫⲟⲣⲉⲓ	sost_verb_grec
ⲡⲗⲏⲣⲟⲫⲟⲣⲓ	sost_verb_grec
ⲡⲟⲗⲉⲙⲉⲓ	sost_verb_grec
ⲡⲟⲗⲓⲧⲉⲩⲉ	sost_verb_grec
ⲡⲟⲗⲩⲙⲉⲓ	sost_verb_grec
ⲡⲟⲛⲏⲣⲉⲩⲉ	sost_verb_grec
ⲡⲟⲟⲛ	sost_verb_pron
ⲡⲟⲟⲛⲉ	sost_verb_pron
ⲡⲟⲣϫ	sost_verb_pronqual
ⲡⲟⲣⲕ	sost_verb_pron
ⲡⲟⲣⲕⲉ	sost_verb_pron
ⲡⲟⲣⲛⲉⲩⲉ	sost_verb_grec
ⲡⲣϣ	sost_verb_nomi
ⲡⲣϫ	sost_verb_nomi
ⲡⲣⲉⲡⲉⲓ	sost_verb_grec
ⲡⲣⲉⲥⲃⲉⲩⲉ	sost_verb_grec
ⲡⲣⲟⲇⲓⲇⲟⲩ	sost_verb_grec
ⲡⲣⲟⲉⲗⲑⲉ	sost_verb_grec
ⲡⲣⲟⲏⲗⲑⲉ	sost_verb_grec
ⲡⲣⲟⲕⲟⲡⲧⲉⲓ	sost_verb_grec
ⲡⲣⲟⲥⲉⲭⲉ	sost_verb_grec
ⲡⲣⲟⲥⲕⲁⲣⲧⲏⲣⲉ	sost_verb_grec
ⲡⲣⲟⲥⲕⲁⲣⲧⲏⲣⲉⲓ	sost_verb_grec
ⲡⲣⲟⲥⲕⲁⲣⲧⲩⲣⲉ	sost_verb_grec
ⲡⲣⲟⲥⲕⲩⲛⲉⲓ	sost_verb_grec
ⲡⲣⲟⲥⲫⲉⲣⲉⲓ	sost_verb_grec
ⲡⲣⲟⲧⲣⲉⲡⲉ	sost_verb_grec
ⲡⲣⲟⲫⲏⲧⲉⲩⲉ	sost_verb_grec
ⲡⲧ	sost_verb_asso
ⲡⲱϣ	sost_verb_asso
ⲡⲱϣⲛ	sost_verb_asso
ⲡⲱϣⲥ	sost_verb_asso
ⲡⲱϩ	sost_verb_asso
ⲡⲱϩⲥ	sost_verb_asso
ⲡⲱϩⲧ	sost_verb_asso
ⲡⲱϭⲉ	sost_verb_asso
ⲡⲱⲗϩ	sost_verb_asso
ⲡⲱⲗϭ	sost_verb_asso
ⲡⲱⲛⲕ	sost_verb_asso
ⲡⲱⲣϣ	sost_verb_asso
ⲡⲱⲣϫ	sost_verb_asso
ⲡⲱⲣⲕ	sost_verb_asso
ⲡⲱⲧ	sost_verb_asso
ⲡⲱⲧⲥ	sost_verb_asso
ⲡⲱⲱⲛⲉ	sost_verb_asso
ⲡⲱⲱⲡⲉ	sost_verb_asso
ⲡⲱⲱⲣⲉ	sost_verb_asso
ⲣ	sost_verb_nomi
ⲣϣⲁ	sost_verb_asso
ⲣϣⲁⲩ	sost_verb_asso
ⲣϣⲙⲙⲟ	sost_verb_asso
ⲣϣⲡⲏⲣⲉ	sost_verb_asso
ⲣϣⲣⲡ	sost_verb_nomi
ⲣϥⲛⲧ	sost_verb_asso
ⲣϩⲁⲗ	sost_verb_asso
ⲣϩⲃⲁ	sost_verb_asso
ⲣϩⲉ	sost_verb_nomi
ⲣϩⲗⲗⲟ	sost_verb_asso
ⲣϩⲙⲙⲉ	sost_verb_asso
ⲣϩⲛⲁ	sost_verb_pron
ⲣϩⲟⲧⲉ	sost_verb_asso
ⲣϩⲱⲃ	sost_verb_asso
ⲣϫⲟⲉⲓⲥ	sost_verb_asso
ⲣϫⲟⲓⲥ	sost_verb_asso
ⲣϫⲟⲗⲉⲥ	sost_verb_asso
ⲣϫⲟⲟⲗⲉⲥ	sost_verb_asso
ⲣⲁϣⲉ	sost_verb_asso
ⲣⲁϩⲧ	sost_verb_pronqual
ⲣⲁⲕⲧⲟⲩ	sost_verb_pron
ⲣⲁⲛⲁ	sost_verb_pron
ⲣⲁⲛⲁϣ	sost_verb_asso
ⲣⲁⲡⲁⲧⲟⲟⲧ	sost_verb_pron
ⲣⲁⲡⲉ	sost_verb_asso
ⲣⲁⲧϣⲁⲩ	sost_verb_asso
ⲣⲁⲧⲥⲱⲧⲙ	sost_verb_asso
ⲣⲉ	sost_verb_asso
ⲣⲉϣⲧ	sost_verb_nomi
ⲣⲉϩⲧ	sost_verb_nomi
ⲣⲉⲕ	sost_verb_nomi
ⲣⲉⲕϩ	sost_verb_nomi
ⲣⲑⲉⲙ	sost_verb_nomi
ⲣⲑⲉⲛ	sost_verb_nomi
ⲣⲓⲕⲉ	sost_verb_asso
ⲣⲓⲙⲉ	sost_verb_asso
ⲣⲕⲁⲕⲉ	sost_verb_asso
ⲣⲙⲛⲧⲣⲉ	sost_verb_asso
ⲣⲛⲟϥⲣⲉ	sost_verb_asso
ⲣⲛⲟⲃⲉ	sost_verb_asso
ⲣⲛⲟⲃⲣⲉ	sost_verb_asso
ⲣⲟⲉⲓⲥ	sost_verb_asso
ⲣⲟⲕϩ	sost_verb_pron
ⲣⲟⲩⲟⲉⲓⲛ	sost_verb_asso
ⲣⲟⲩⲟⲓⲛ	sost_verb_asso
ⲣⲡⲃⲟⲗ	sost_verb_asso
ⲣⲡⲙⲉⲉⲩⲉ	sost_verb_asso
ⲣⲡⲱⲃϣ	sost_verb_asso
ⲣⲧⲣⲟⲫⲏ	sost_verb_asso
ⲣⲱϣⲉ	sost_verb_asso
ⲣⲱϩⲉ	sost_verb_asso
ⲣⲱϩⲧ	sost_verb_asso
ⲣⲱⲕϩ	sost_verb_asso
ⲥϩⲁⲓ	sost_verb_assosost_verb_pron
ⲥϩⲟⲩⲱⲣ	sost_verb_pron
ⲥⲁϩ	sost_asso_egiz_mafe_siplsost_verb_pron
ⲥⲁϩⲟⲩ	sost_verb_asso
ⲥⲁϩⲱ	sost_verb_pronsost_verb_pron
ⲥⲁⲁⲛϣ	sost_verb_asso
ⲥⲁⲁⲧ	sost_verb_pron
ⲥⲁⲗⲡⲓⲍⲉ	sost_verb_grec
ⲥⲁⲛϣ	sost_verb_asso
ⲥⲃⲃⲉ	sost_verb_asso
ⲥⲃⲧⲉ	sost_verb_asso
ⲥⲃⲧⲱⲧ	sost_verb_pronqual
ⲥⲉ	refe_partnumeinte_egizsost_verb_nomi
ⲥⲉϣϥ	sost_verb_nomi
ⲥⲉϩ	sost_verb_nomi
ⲥⲉⲉⲡⲉ	sost_verb_asso
ⲥⲉⲓ	sost_verb_asso
ⲥⲉⲡⲥⲡ	sost_verb_nomi
ⲥⲉⲡⲥⲱⲡ	sost_verb_pron
ⲥⲉⲡⲥⲱⲡⲉ	sost_verb_pron
ⲥⲉⲧⲡ	sost_verb_nomi
ⲥⲉⲩϩ	sost_verb_nomi
ⲥⲏⲏⲡⲉ	sost_verb_asso
ⲥⲏⲙⲁⲛⲉ	sost_verb_grec
ⲥⲕⲁⲛⲇⲁⲗⲓⲍⲉ	sost_verb_grec
ⲥⲕⲉⲡⲁⲍⲉ	sost_verb_grec
ⲥⲕⲉⲡⲧⲉ	sost_verb_grec
ⲥⲕⲉⲡⲧⲉⲓ	sost_verb_grec
ⲥⲕⲉⲣⲕⲱⲣ	sost_verb_pron
ⲥⲕⲉⲣⲕⲱⲣⲉ	sost_verb_pron
ⲥⲕⲟⲣⲕⲉⲣ	sost_verb_asso
ⲥⲕⲟⲣⲕⲣ	sost_verb_asso
ⲥⲕⲣⲕⲣ	sost_verb_nomi
ⲥⲕⲩⲗⲗⲉⲓ	sost_verb_grec
ⲥⲗⲁⲁⲧⲉ	sost_verb_asso
ⲥⲗⲥⲱⲗ	sost_verb_pron
ⲥⲙⲉⲛⲥⲉⲛⲧⲉ	sost_verb_asso
ⲥⲙⲉⲛⲥⲛⲧⲉ	sost_verb_asso
ⲥⲙⲓⲛⲉ	sost_verb_asso
ⲥⲙⲙⲉ	sost_verb_asso
ⲥⲙⲛ	sost_verb_nomi
ⲥⲙⲛⲥⲉⲛⲧⲉ	sost_verb_asso
ⲥⲙⲛⲧϥ	sost_verb_pron
ⲥⲙⲟⲩ	sost_verb_asso
ⲥⲟϣ	sost_verb_pron
ⲥⲟϣⲕ	sost_verb_pron
ⲥⲟϩⲉ	sost_verb_asso
ⲥⲟⲃⲧⲉ	sost_verb_asso
ⲥⲟⲕ	sost_verb_pron
ⲥⲟⲗⲥⲉⲗ	sost_verb_asso
ⲥⲟⲗⲥⲗ	sost_verb_asso
ⲥⲟⲛϩ	sost_verb_pronqual
ⲥⲟⲛϩⲉ	sost_verb_pron
ⲥⲟⲛⲧ	sost_verb_pron
ⲥⲟⲟ
ⲥⲟⲟϩⲉ	sost_verb_asso
ⲥⲟⲟⲧ	sost_verb_pron
ⲥⲟⲟⲩϩ	sost_verb_pronqual
ⲥⲟⲟⲩϩⲛ	sost_verb_pron
ⲥⲟⲟⲩⲛ	sost_verb_asso
ⲥⲟⲟⲩⲧⲛ	sost_verb_asso
ⲥⲟⲡⲥ	sost_verb_asso
ⲥⲟⲣ	sost_verb_pron
ⲥⲟⲣⲙ	sost_verb_asso
ⲥⲟⲧ	sost_verb_pron
ⲥⲟⲧⲙ	sost_verb_pronsost_verb_pron
ⲥⲟⲧⲙϥ	sost_verb_pron
ⲥⲟⲧⲙⲉ	sost_verb_pron
ⲥⲟⲧⲙⲉϥ	sost_verb_pron
ⲥⲟⲧⲡ	sost_verb_pronqual
ⲥⲟⲩⲉⲛ	sost_verb_nomi
ⲥⲟⲩⲛ	sost_verb_nomi
ⲥⲟⲩⲟⲛ	sost_verb_pron
ⲥⲟⲩⲧⲛ	sost_verb_nomi
ⲥⲟⲩⲱⲛ	sost_verb_pron
ⲥⲟⲫⲓⲍⲉ	sost_verb_grec
ⲥⲡⲁⲧⲁⲗⲁ	sost_verb_grec
ⲥⲡⲟⲩⲇⲁⲍⲉ	sost_verb_grec
ⲥⲡⲥⲱⲡ	sost_verb_pron
ⲥⲡⲥⲱⲡⲉ	sost_verb_pron
ⲥⲣϥⲉ	sost_verb_asso
ⲥⲣⲟϥⲣϥ	sost_verb_asso
ⲥⲣⲟϥⲣⲉϥ	sost_verb_asso
ⲥⲧⲁⲁⲧⲉ	sost_verb_asso
ⲥⲧⲁⲩⲣⲟⲩ	sost_verb_grec
ⲥⲧⲉⲫⲁⲛⲟⲩ	sost_verb_grec
ⲥⲧⲏⲫⲁⲛⲟⲩ	sost_verb_grec
ⲥⲧⲓⲗⲓⲧⲉⲩⲉ	sost_verb_grec
ⲥⲧⲟ	sost_verb_assosost_verb_pron
ⲥⲧⲟⲟⲩ	sost_verb_asso
ⲥⲧⲱⲧ	sost_verb_asso
ⲥⲩⲗⲁ	sost_verb_grec
ⲥⲩⲙⲁⲛⲉ	sost_verb_grec
ⲥⲩⲙⲃⲟⲩⲗⲉⲩⲉ	sost_verb_grec
ⲥⲩⲙⲫⲟⲛⲉⲓ	sost_verb_grec
ⲥⲩⲙⲫⲱⲛⲉⲓ	sost_verb_grec
ⲥⲩⲛϩⲓⲥⲧⲁ	sost_verb_grec
ⲥⲩⲛⲁⲅⲉ	sost_verb_grec
ⲥⲩⲛⲁⲓⲛⲉⲓ	sost_verb_grec
ⲥⲩⲛⲉⲭⲉ	sost_verb_grec
ⲥⲩⲛⲏⲛⲉⲓ	sost_verb_grec
ⲥⲩⲛⲧⲉⲭⲉ	sost_verb_grec
ⲥⲩⲛⲧⲩⲭⲉ	sost_verb_grec
ⲥⲩⲣⲁ	sost_verb_grec
ⲥⲩⲥⲧⲣⲟⲫⲉⲓ	sost_verb_grec
ⲥⲫⲣⲁⲅⲓⲍⲉ	sost_verb_grec
ⲥⲱ	sost_verb_asso
ⲥⲱϣ	sost_verb_asso
ⲥⲱϣϥ	sost_verb_asso
ⲥⲱϣⲉⲙ	sost_verb_asso
ⲥⲱϣⲙ	sost_verb_asso
ⲥⲱϣⲧ	sost_verb_asso
ⲥⲱϩⲉ	sost_verb_asso
ⲥⲱϩⲡ	sost_verb_asso
ⲥⲱϩⲣ	sost_verb_asso
ⲥⲱⲃϩ	sost_verb_asso
ⲥⲱⲃⲉ	sost_verb_asso
ⲥⲱⲕ	sost_verb_asso
ⲥⲱⲛϩ	sost_verb_asso
ⲥⲱⲛⲧ	sost_verb_asso
ⲥⲱⲟⲩϩ	sost_verb_asso
ⲥⲱⲟⲩϩⲉϩⲟⲩⲛ	sost_verb_asso
ⲥⲱⲣ	sost_verb_asso
ⲥⲱⲣⲉⲙ	sost_verb_asso
ⲥⲱⲣⲙ	sost_verb_asso
ⲥⲱⲧⲉ	sost_verb_asso
ⲥⲱⲧⲙ	sost_verb_asso
ⲥⲱⲧⲡ	sost_verb_asso
ⲥⲱⲱϥ	sost_verb_asso
ⲧϩⲟ	sost_verb_asso
ⲧϭⲁⲉⲓⲟ	sost_verb_assosost_verb_pron
ⲧϭⲁⲓⲟ	sost_verb_pron
ⲧⲁϣⲉ	sost_verb_nomi
ⲧⲁϣⲉⲟⲉⲓϣ	sost_verb_asso
ⲧⲁϣⲟ	sost_verb_asso
ⲧⲁϩ	sost_verb_pron
ⲧⲁϩⲉ	sost_verb_nomiqual
ⲧⲁϩⲙ	sost_verb_pronqual
ⲧⲁϩⲙⲉ	sost_verb_pronqual
ⲧⲁϩⲛⲟ	sost_verb_asso
ⲧⲁϩⲟ	sost_verb_assosost_verb_pron
ⲧⲁϩⲥ	sost_verb_pron
ⲧⲁϩⲭ	sost_verb_pron
ⲧⲁϫⲣⲉ	sost_verb_nomi
ⲧⲁϫⲣⲟ	sost_verb_asso
ⲧⲁⲁ	sost_verb_pron
ⲧⲁⲁⲧⲉ	sost_verb_asso
ⲧⲁⲉⲓⲟ	sost_verb_asso
ⲧⲁⲓⲟ	sost_verb_asso
ⲧⲁⲕⲉ	sost_verb_nomisost_verb_nomi
ⲧⲁⲕⲟ	sost_verb_assosost_verb_pron
ⲧⲁⲗϭⲉ	sost_verb_nomi
ⲧⲁⲗϭⲟ	sost_verb_assosost_verb_pron
ⲧⲁⲗⲁⲓⲡⲟⲣⲉⲓ	sost_verb_grec
ⲧⲁⲗⲁⲓⲡⲱⲣⲉⲓ	sost_verb_grec
ⲧⲁⲗⲉⲡⲟⲣⲉⲓ	sost_verb_grec
ⲧⲁⲗⲉⲡⲱⲣⲉⲓ	sost_verb_grec
ⲧⲁⲗⲟ	sost_verb_assosost_verb_pron
ⲧⲁⲗⲟⲉϩⲣⲁⲓ	sost_verb_asso
ⲧⲁⲙⲉ	sost_verb_nomi
ⲧⲁⲙⲉⲓⲉ	sost_verb_nomi
ⲧⲁⲙⲉⲓⲟ	sost_verb_assosost_verb_pron
ⲧⲁⲙⲓⲉ	sost_verb_nomi
ⲧⲁⲙⲓⲟ	sost_verb_assosost_verb_pron
ⲧⲁⲙⲟ	sost_verb_assosost_verb_pron
ⲧⲁⲙⲱ	sost_verb_pron
ⲧⲁⲛϩⲉ	sost_verb_nomi
ⲧⲁⲛϩⲉⲧ	sost_verb_nomi
ⲧⲁⲛϩⲟ	sost_verb_assosost_verb_pron
ⲧⲁⲛϩⲟⲩⲧ	sost_verb_assosost_verb_pron
ⲧⲁⲟⲩⲉ	sost_verb_nomi
ⲧⲁⲟⲩⲟ	sost_verb_assosost_verb_pron
ⲧⲁⲣⲁⲥⲥⲉ	sost_verb_grec
ⲧⲁⲣⲕⲟ	sost_verb_asso
ⲧⲁⲩⲉ	sost_verb_nomi
ⲧⲁⲩⲟ	sost_verb_assosost_verb_pron
ⲧⲃⲃⲉ	sost_verb_nomi
ⲧⲃⲃⲟ	sost_verb_asso
ⲧⲉϩⲛⲉ	sost_verb_nomi
ⲧⲉⲃⲥ	sost_verb_nomi
ⲧⲉⲕⲙ	sost_verb_nomi
ⲧⲉⲗⲏⲗ	sost_verb_asso
ⲧⲉⲛⲛⲟⲟⲩ	sost_verb_asso
ⲧⲉⲛⲛⲟⲟⲩⲥ	sost_verb_pron
ⲧⲉⲛⲧⲏⲩⲧⲛ	sost_verb_pron
ⲧⲉⲛⲧⲱⲛⲧ	sost_verb_pron
ⲧⲓⲙⲟⲣⲉⲓ	sost_verb_grec
ⲧⲓⲙⲟⲣⲓ	sost_verb_grec
ⲧⲓⲙⲱⲣⲉⲓ	sost_verb_grec
ⲧⲓⲙⲱⲣⲓ	sost_verb_grec
ⲧⲙⲁⲓⲟ	sost_verb_asso
ⲧⲙⲁⲓⲟⲕ	sost_verb_pron
ⲧⲙⲙⲟ	sost_verb_asso
ⲧⲙⲟ	sost_verb_pron
ⲧⲛⲛⲟⲟⲩ	sost_verb_assosost_verb_pron
ⲧⲛⲧⲱⲛ	sost_verb_pronqual
ⲧⲟϣ	sost_asso_egiz_masc_siplsost_verb_pron
ⲧⲟϭ	sost_verb_pron
ⲧⲟϭⲉ	sost_verb_pron
ⲧⲟⲃⲥ	sost_verb_pron
ⲧⲟⲉⲓⲧ	sost_verb_asso
ⲧⲟⲗⲙⲁ	sost_verb_grec
ⲧⲟⲗⲟⲙⲁ	sost_verb_grec
ⲧⲟⲙⲥ	sost_verb_pronqual
ⲧⲟⲛⲧⲉⲛ	sost_verb_asso
ⲧⲟⲛⲧⲛ	sost_verb_assosost_verb_nomi
ⲧⲟⲟⲃ	sost_verb_pron
ⲧⲟⲣⲡ	sost_verb_pron
ⲧⲟⲩϫⲉ	sost_verb_nomi
ⲧⲟⲩϫⲟ	sost_verb_assosost_verb_pron
ⲧⲟⲩⲉⲓⲟ	sost_verb_asso
ⲧⲟⲩⲓⲟ	sost_verb_asso
ⲧⲟⲩⲛⲉⲉⲓⲁⲁ	sost_verb_pron
ⲧⲟⲩⲛⲉⲉⲓⲁⲁⲧ	sost_verb_pron
ⲧⲟⲩⲛⲉⲓⲁⲧ
ⲧⲟⲩⲛⲉⲥ	sost_verb_nomi
ⲧⲟⲩⲛⲟⲥ	sost_verb_assosost_verb_pron
ⲧⲣⲩⲫⲁ	sost_verb_grec
ⲧⲥⲁⲃⲉⲓⲁ	sost_verb_pron
ⲧⲥⲁⲃⲓⲁ	sost_verb_pron
ⲧⲥⲁⲃⲟ	sost_verb_assosost_verb_pron
ⲧⲥⲁⲉⲓⲟ	sost_verb_asso
ⲧⲥⲁⲓⲟ	sost_verb_asso
ⲧⲥⲁⲛⲉ	sost_verb_nomi
ⲧⲥⲁⲛⲟ	sost_verb_asso
ⲧⲥⲁⲛⲟⲥ	sost_verb_pron
ⲧⲥⲉ	sost_verb_nomi
ⲧⲥⲉⲓⲁ	sost_verb_nomi
ⲧⲥⲉⲓⲟ	sost_verb_asso
ⲧⲥⲉⲛⲕⲟ	sost_verb_asso
ⲧⲥⲓⲉ	sost_verb_nomi
ⲧⲥⲓⲟ	sost_verb_assosost_verb_pron
ⲧⲥⲛⲕⲟ	sost_verb_asso
ⲧⲥⲟ	sost_verb_asso
ⲧⲥⲧⲉ	sost_verb_nomi
ⲧⲥⲧⲟ	sost_verb_asso
ⲧⲱϣ	sost_verb_asso
ⲧⲱϩ	sost_verb_asso
ⲧⲱϩⲙ	sost_verb_asso
ⲧⲱϭ	sost_verb_asso
ⲧⲱϭⲉ	sost_verb_asso
ⲧⲱϭⲛ	sost_verb_asso
ⲧⲱϭⲥ	sost_verb_asso
ⲧⲱⲃϩ	sost_verb_asso
ⲧⲱⲃⲉ	sost_verb_asso
ⲧⲱⲃⲥ	sost_verb_asso
ⲧⲱⲕ	sost_verb_asso
ⲧⲱⲕⲙ	sost_verb_asso
ⲧⲱⲕⲛϩⲏⲧ	sost_verb_asso
ⲧⲱⲕⲥ	sost_verb_asso
ⲧⲱⲗⲙ	sost_verb_asso
ⲧⲱⲗⲱⲙⲁ	sost_verb_grec
ⲧⲱⲙ	sost_verb_asso
ⲧⲱⲙⲛⲧ	sost_verb_asso
ⲧⲱⲙⲣⲱ	sost_verb_pron
ⲧⲱⲙⲥ	sost_verb_asso
ⲧⲱⲙⲧ	sost_verb_asso
ⲧⲱⲟⲩⲛ	sost_verb_asso
ⲧⲱⲣⲡ	sost_verb_asso
ⲧⲱⲥ	sost_verb_asso
ⲧⲱⲧⲛϩⲏⲧ	sost_verb_asso
ⲧⲱⲱⲃⲉ	sost_verb_asso
ⲧⲱⲱⲙⲉ	sost_verb_asso
ⲫⲑⲟⲛⲉⲓ	sost_verb_grec
ⲫⲓⲗⲟⲥⲟⲫⲉⲓ	sost_verb_grec
ⲫⲟⲣⲉⲓ	sost_verb_grec
ⲫⲟⲣⲓ	sost_verb_grec
ⲫⲣⲁⲅⲉⲗⲗⲟⲩ	sost_verb_grec
ⲫⲣⲟⲛⲉⲓ	sost_verb_grec
ⲫⲱⲣⲉⲓ	sost_verb_grec
ⲭⲁⲗⲁ	sost_verb_grec
ⲭⲁⲣⲓⲍⲉ	sost_verb_grec
ⲭⲉⲓⲣⲟⲧⲟⲛⲉⲓ	sost_verb_grec
ⲭⲗⲉⲩⲁⲍⲉ	sost_verb_grec
ⲭⲟⲣⲉⲅⲉⲓ	sost_verb_grec
ⲭⲟⲣⲉⲩⲉ	sost_verb_grec
ⲭⲟⲣⲩⲅⲉⲓ	sost_verb_grec
ⲭⲣⲉⲱⲥⲧⲉⲓ	sost_verb_grec
ⲭⲣⲏⲙⲁⲧⲓⲍⲉ	sost_verb_grec
ⲭⲣⲏⲱⲥⲧⲓ	sost_verb_grec
ⲭⲣⲩⲱⲥⲧⲉ	sost_verb_grec
ⲭⲣⲱ	sost_verb_grec
ⲭⲱⲣⲉⲩⲉ	sost_verb_grec
ⲭⲱⲣⲏⲅⲉⲓ	sost_verb_grec
ⲯⲁⲗⲉⲓ	sost_verb_grec
ⲯⲁⲗⲗⲉⲓ	sost_verb_grec
ⲱϣ	sost_verb_asso
ⲱϣⲉⲃⲟⲗ	sost_verb_asso
ⲱϩⲉ	sost_verb_asso
ⲱϩⲥⲉ	sost_verb_asso
ⲱϫⲛ	sost_verb_asso
ⲱϭⲃ	sost_verb_asso
ⲱϭⲉⲃ	sost_verb_asso
ⲱϭⲧ	sost_verb_asso
ⲱⲃϣ	sost_verb_asso
ⲱⲕⲙ	sost_verb_asso
ⲱⲗⲉⲙ	sost_verb_asso
ⲱⲗⲙ	sost_verb_asso
ⲱⲙⲥ	sost_verb_asso
ⲱⲛϣ	sost_verb_asso
ⲱⲛϩ	sost_verb_asso
ⲱⲡ	sost_verb_asso
ⲱⲣϫ	sost_verb_asso
ⲱⲣⲉϫ	sost_verb_asso
ⲱⲣⲕ	sost_verb_asso
ⲱⲣⲙ	sost_verb_asso
ⲱⲥϭ	sost_verb_asso
ⲱⲥⲕ	sost_verb_asso
ⲱⲧⲡ	sost_verb_asso
ⲱⲫⲉⲗⲉⲓ	sost_verb_grec
ϣⲱⲡⲉ	sost_verb_asso
ϯ	refe_partrefe_dimonumesost_verb_assosost_verb_nomi
ⲣ	sost_verb_nomi
ϫⲟⲟ	sost_verb_pron
ⲉⲓ	refe_partsost_verb_asso
ϫⲓ	avve_egizprep_nomi_egizsost_verb_assosost_verb_nomisost_verb_pron
ⲉⲓⲣⲉ	sost_verb_asso
ⲕⲱ	sost_verb_asso
ⲥⲱⲧⲙ	sost_verb_asso
ⲕⲁ	sost_verb_nomi
ⲕⲧⲟ	sost_verb_assosost_verb_pron
ⲉⲓⲙⲉ	sost_verb_asso
ⲙⲓϣⲉ	sost_verb_asso
ⲙⲉⲣⲉ	trip
ⲧⲁⲕⲟ	sost_verb_assosost_verb_pron
ⲙⲟⲟϣⲉ	sost_verb_asso
ⲥⲁϩⲟⲩ	sost_verb_asso
ⲣⲛⲟⲃⲉ	sost_verb_asso
ϫⲱ	sost_egiz_pronsost_verb_asso
ⲛⲁⲩ	sost_asso_egiz_masc_siplsost_verb_asso
ϫⲱϩⲙ	sost_verb_asso
ⲙⲕⲁϩ	sost_verb_asso
ⲣϩⲟⲧⲉ	sost_verb_asso
ⲛⲕⲟⲧⲕ	sost_verb_asso
ϩⲉ	sost_asso_egiz_femm_siplsost_verb_asso
ϭⲱ	sost_verb_asso
ϫⲡⲟ	sost_verb_assosost_verb_pron
ϫⲱⲕ	sost_verb_asso
ⲧⲁⲙⲟ	sost_verb_assosost_verb_pron
ⲉⲧⲉⲣⲉ	conv
ⲗⲩⲡⲉⲓ	sost_verb_grec
ⲙⲟⲩⲧⲉ	sost_verb_asso
ⲣⲕⲁⲕⲉ	sost_verb_asso
ⲥⲟⲟⲩⲛ	sost_verb_asso
ⲧⲛⲧⲱⲛ	sost_verb_pronqual
ⲧⲱⲱⲃⲉ	sost_verb_asso
ⲡⲁⲣⲁⲃⲁ	sost_verb_grec
ⲣⲭⲣⲉⲓⲁ
ⲥⲁⲛⲟⲩϣ
ϥⲓ	sost_verb_assosost_verb_nomi
ⲥⲣ
ϣⲱⲡ	sost_verb_asso
ϩⲱⲡ	sost_verb_asso
ⲃⲱⲕ	sost_verb_assosost_verb_asso
ⲙⲟⲩ	sost_verb_asso
ⲥⲱϣ	sost_verb_asso
ⲡⲱⲧ	sost_verb_asso
ⲧⲱⲧ
ϣⲁϫⲉ	sost_verb_asso
ϣⲁⲣⲉ	trip
ϣⲓⲛⲉ	sost_verb_asso
ϣⲟⲕϩ
ⲣϩⲱⲃ	sost_verb_asso
ⲙⲡϣⲁ	sost_verb_asso
ⲕⲱⲧⲉ	sost_verb_asso
ⲙⲁⲧⲉ	sost_verb_asso
ⲣⲱϩⲧ	sost_verb_asso
ⲟⲩⲱϣ	sost_verb_asso
ⲥⲙⲟⲩ	sost_verb_asso
ⲥⲱⲱϥ	sost_verb_asso
ⲧⲁⲙⲱ	sost_verb_pron
ϩⲟⲟⲩϣ
ϫⲓⲟⲩⲉ	sost_verb_asso
ⲣϩⲟⲩⲟ
ⲃⲟⲟⲛⲉ
ⲙⲉϣϣⲉ	sost_verb_asso
ⲕⲱⲗⲩⲉ	sost_verb_grec
ⲙⲁⲩⲁⲧ	agge_pron
ⲙⲉⲉⲩⲉ	sost_verb_asso
ⲙⲟⲥⲧⲉ	sost_verb_asso
ⲛⲉⲃⲟⲗ
ⲟⲩⲁϩⲙ
ⲟⲩⲱⲛϩ	sost_verb_asso
ⲡⲱⲱⲛⲉ	sost_verb_asso
ⲧⲁⲙⲓⲉ	sost_verb_nomi
ⲧⲁⲙⲓⲟ	sost_verb_assosost_verb_pron
ⲧⲥⲁⲃⲱ
ⲧⲱⲟⲩⲛ	sost_verb_asso
ⲉⲝⲁⲡⲁⲧⲁ	sost_verb_grec
ⲙⲉⲗⲉⲧⲁ	sost_verb_grec
ⲟⲩⲟⲓⲉϣ
ⲥⲗⲁⲁⲧⲉ	sost_verb_asso
ⲥⲣⲙⲣⲱⲙ
ⲧⲁⲩⲟⲩⲟ
ⲧⲛⲛⲟⲟⲩ	sost_verb_assosost_verb_pron
ⲧⲟⲩⲛⲟⲥ	sost_verb_assosost_verb_pron
ⲕⲁⲧⲁⲫⲣⲟⲛⲉⲓ	sost_verb_grec
ⲫⲑⲟⲛⲉⲓ	sost_verb_grec
ϩⲟⲙⲟⲗⲟⲅⲉⲓ	sost_verb_grec
ϣϭⲙϭⲟⲙ
ϥⲟ
ϫⲉ	cong_egizsost_verb_nomi
ϫⲟ	sost_verb_assosost_verb_pron
ⲁⲁ	sost_verb_pron
ⲉⲡ
ⲙⲉ	triptripsost_asso_egiz_femm_siplsost_verb_asso
ϣⲟⲡ	sost_verb_pron
ϣⲱⲗ	sost_verb_asso
ϩⲉⲡ	sost_verb_nomi
ϩⲕⲟ	sost_verb_asso
ϫⲓⲧ	sost_verb_pron
ϫⲛⲉ	sost_verb_nomi
ϭⲓⲛ
ⲕⲁⲁ	sost_verb_pron
ⲕⲉⲧ	sost_asso_egiz_masc_singsost_verb_nomi
ⲧⲟϣ	sost_asso_egiz_masc_siplsost_verb_pron
ⲧⲱϣ	sost_verb_asso
ⲟⲩⲉ	sost_verb_asso
ⲥⲉⲓ	sost_verb_asso
ⲧⲁⲁ	sost_verb_pron
ⲧⲥⲟ	sost_verb_asso
ϣⲁⲁⲧ	sost_verb_pronqual
ϣⲁⲣⲱ
ϣⲓⲃⲉ	sost_verb_asso
ϣⲓⲕⲉ	sost_verb_asso
ϣⲗⲏⲗ	sost_verb_asso
ϣⲱⲛⲉ	sost_verb_asso
ϣⲱⲱⲧ	sost_verb_asso
ϩⲱⲣⲡ
ϫⲉⲣⲱ	sost_verb_pron
ϫⲓⲧⲉ
ϫⲟⲟⲩ	sost_verb_asso
ϫⲡⲓⲟ	sost_verb_pron
ⲉϣϣⲉ	verb_imps
ⲣϩⲁϩ
ⲣϩⲛⲁ	sost_verb_pron
ⲉⲓⲁⲧ
ⲉⲓⲃⲉ	sost_verb_asso
ⲑⲙⲕⲟ	sost_verb_assosost_verb_pron
ⲗⲩⲡⲏ	sost_verb_grec
ⲣⲱϣⲉ	sost_verb_asso
ⲙⲧⲟⲛ	sost_verb_asso
ⲛⲟⲩϫ	sost_verb_asso
ⲟⲩⲁϩ	sost_verb_pron
ⲟⲩⲉϣ	sost_verb_nomi
ⲟⲩⲉϩ
ⲟⲩⲱϩ	sost_verb_asso
ⲡⲱⲣϫ	sost_verb_asso
ⲣⲥⲟϭ
ⲥⲁⲛϣ	sost_verb_asso
ⲥⲟⲧⲡ	sost_verb_pronqual
ⲥⲱⲣⲙ	sost_verb_asso
ⲥⲱⲧⲡ	sost_verb_asso
ⲧⲁⲓⲉ
ⲧⲁⲓⲟ	sost_verb_asso
ⲧⲁⲕⲉ	sost_verb_nomisost_verb_nomi
ⲧⲁⲙⲉ	sost_verb_nomi
ⲧⲙⲙⲟ	sost_verb_asso
ⲧⲥⲧⲟ	sost_verb_asso
ⲱⲟⲟⲡ
ϩⲟϫϩϫ	sost_verb_asso
ϣⲉⲡϣⲡ
ϭⲙϭⲟⲙ	sost_verb_asso
ϫⲟⲡϫⲡ
ⲙⲉⲧⲁⲛⲟⲉⲓ	sost_verb_grec
ⲧϭⲁⲓⲉ
ⲣⲣⲙⲙⲁⲟ
ⲛⲧ	convsost_verb_pron
ϩⲁⲡⲥ	verb_pron
ϩⲛⲁ	verb_pron
ϩⲛⲉ	verb_nomi
ⲁϩⲣⲟ	verb_pron
ⲁϩⲣⲱ	verb_pron
ⲉϩⲛⲁ	verb_pron
ⲉϩⲛⲉ	verb_nomi
ⲙⲁⲣⲟ
ⲛⲁϣⲉ	verb_nomi
ⲛⲁϣⲱ	verb_pron
ⲛⲁⲉⲓⲁⲧ	verb_pron
ⲛⲁⲓⲁⲧ	verb_pron
ⲛⲁⲛⲟⲩ	verb_pron
ⲛⲉⲥⲱ	verb_pron
ⲟⲩⲉⲧ	verb_nomi
ⲡⲉϫⲁ	verb_pron
ⲡⲉϫⲉ	verb_nomi
ⲁϫⲓ	impe_pron
ⲁⲗⲱⲧ	impe_pron
ⲁⲙⲏⲉⲓ	impe_asso
ⲁⲙⲏⲉⲓⲛ	impe_asso
ⲁⲙⲏⲉⲓⲧⲛ	impe_asso
ⲁⲙⲏⲓ	impe_asso
ⲁⲙⲏⲓⲧⲛ	impe_asso
ⲁⲙⲟⲩ	impe_asso
ⲁⲙⲟⲩⲧⲉ	impe_asso
ⲁⲛⲁⲩ	impe_asso
ⲁⲛⲓ	impe_pron
ⲁⲣⲓ	impe_nomi
ⲁⲣⲓⲣⲉ	impe_asso
ⲙⲁⲧⲁⲙⲟ	impe_pron
ⲙⲁⲧⲟⲩϫⲟ	impe_pron
ⲙⲡⲣ	nega
ϣⲁⲁⲧ	sost_verb_pronqual
ϣⲉⲧϣⲱⲧ	qual
ϣⲏϣ	qual
ϣⲏϥ	qual
ϣⲏⲕ	qual
ϣⲏⲡ	qualqual
ϣⲟⲃⲉ	qual
ϣⲟⲗϩ	qual
ϣⲟⲟⲡ	qual
ϣⲟⲧⲙ	qual
ϣⲟⲩⲉⲓⲧ	qual
ϣⲟⲩⲟⲉⲓⲧ	qual
ϣⲟⲩⲱⲟⲩ	qual
ϣⲣϣⲱⲣ	sost_verb_pronqual
ϣⲧⲣⲧⲱⲣ	sost_verb_pronqual
ϩⲏϣ	qual
ϩⲏⲙ	qual
ϩⲏⲛ	qual
ϩⲏⲛⲧ	qual
ϩⲏⲡ	qual
ϩⲕⲁⲉⲓⲧ	qual
ϩⲗⲟⲥⲧⲛ	qual
ϩⲙⲟⲙ	qual
ϩⲟⲗϭ	qual
ϩⲟⲟⲩ	sost_asso_egiz_masc_siplqual
ϩⲟⲣϣ	qual
ϩⲟⲥⲉ	qual
ϩⲟⲧⲣ	qual
ϩⲧⲉⲙⲧⲟⲙⲧ	qual
ϩⲧⲉⲙⲧⲱⲙ	qual
ϩⲧⲙⲧⲟⲙⲧ	qual
ϩⲧⲙⲧⲱⲙ	qual
ϫⲁϩⲙ	sost_verb_pronqual
ϫⲁϫⲱ	qual
ϫⲏϩ	qual
ϫⲏⲕ	qual
ϫⲏⲣ	qual
ϫⲏⲩⲛϭⲟⲛⲥ	qual
ϫⲟⲛⲧ	qual
ϫⲟⲟⲣ	sost_verb_pronqual
ϫⲟⲟⲣⲉ	sost_verb_pronqual
ϫⲟⲥⲉ	qual
ϫⲣⲁⲉⲓⲧ	qual
ϫⲣⲟⲉⲓⲧ	qual
ϭⲁⲗⲱⲟⲩ	qual
ϭⲉⲉⲧ	qual
ϭⲏⲡ	qual
ϭⲏⲩ	qual
ϭⲟϫϥ	qual
ϭⲟϫⲃ	qual
ϭⲟⲗⲡ	sost_verb_pronqual
ϭⲟⲛⲧ	qual
ϭⲟⲟⲗⲉ	sost_verb_pronqual
ϭⲟⲥⲙ	qual
ⲁϣⲉ	qual
ⲁⲗⲏⲩ	qual
ⲁⲥⲱⲟⲩ	qual
ⲃⲏⲕ	qual
ⲃⲏⲗ	qual
ⲃⲏⲧ	qual
ⲉⲗⲏⲩ	qual
ⲏⲡ	qual
ⲑⲃⲃⲓⲏⲩ	qual
ⲕⲉⲓⲱⲟⲩ	qual
ⲕⲏ	qual
ⲕⲏⲃ	qual
ⲕⲏⲕⲁϩⲏⲩ	qual
ⲕⲏⲧ	qual
ⲕⲓⲱⲟⲩ	qual
ⲕⲣⲙⲣⲱⲙ	qual
ⲕⲣⲱⲟⲩ	qual
ⲕⲧⲏⲩ	qual
ⲗⲉϥⲗⲱϥ	qual
ⲗⲏϭ	qual
ⲗⲟϫⲧ	qual
ⲗⲟⲃϣ	qual
ⲗⲟⲃⲉ	qual
ⲗⲟⲕⲥ	sost_verb_pronqual
ⲗⲟⲙⲥ	qual
ⲙⲉϩ	adnusost_verb_nomiqual
ⲙⲏϩ	qual
ⲙⲏⲛ	qual
ⲙⲏⲣ	qual
ⲙⲟϫϭ	sost_verb_pronqual
ⲙⲟϫⲧ	qual
ⲙⲟⲕϩ	qual
ⲙⲟⲕϩⲥ	qual
ⲙⲟⲕⲉϩ	qual
ⲙⲟⲗϩ	sost_verb_pronqual
ⲙⲟⲟⲩⲧ	sost_verb_pronqual
ⲙⲟⲧⲉⲛ	qual
ⲙⲟⲧⲛ	qual
ⲛϩⲟⲧ	qual
ⲛⲁ	refe_dimo_possrefe_dimo_pronfutuprep_pron_egizsost_verb_asso
ⲛⲁϣⲧ	qual
ⲛⲏϫ	qual
ⲛⲏⲩ	qual
ⲛⲟϭⲥ	qual
ⲟ	qual
ⲟϣ	sost_verb_pronqual
ⲟϥⲧ	qual
ⲟⲃⲉ	qual
ⲟⲕⲙ	qual
ⲟⲛϩ	qual
ⲟⲣϫ	sost_verb_pronqual
ⲟⲧⲡ	qual
ⲟⲩⲁⲁⲃ	qual
ⲟⲩⲏϩ	qual
ⲟⲩⲏⲛ	qual
ⲟⲩⲏⲩ	qual
ⲟⲩⲟϣⲥ	qual
ⲟⲩⲟϫ	qual
ⲟⲩⲟϭⲉ	qual
ⲟⲩⲟϭⲡ	qual
ⲟⲩⲟⲛϩ	sost_verb_pronqual
ⲟⲩⲟⲟϩⲉ	qual
ⲟⲩⲟⲟⲗⲉ	qual
ⲟⲩⲟⲧⲃ	qual
ⲡⲏϣ	qual
ⲡⲏϩ	qual
ⲡⲏⲧ	qual
ⲡⲟⲣϣ	qual
ⲡⲟⲣϫ	sost_verb_pronqual
ⲡⲟⲥⲉ	qual
ⲡⲣⲉⲓⲱⲟⲩ	qual
ⲣⲁϩⲧ	sost_verb_pronqual
ⲣⲏⲧ	qual
ⲣⲟⲟⲩⲧ	qual
ⲥϩⲟⲩⲟⲣⲧ	qual
ⲥϭⲣⲁϩⲧ	qual
ⲥⲁϣⲉ	qual
ⲥⲁϣⲧ	qual
ⲥⲁϩⲏⲩ	qual
ⲥⲃⲧⲱⲧ	sost_verb_pronqual
ⲥⲉϭⲣⲁϩⲧ	qual
ⲥⲏϣ	qual
ⲥⲏϩ	qual
ⲥⲏϭ	qual
ⲥⲏⲣ	qual
ⲥⲙⲁⲙⲁⲁⲧ	qual
ⲥⲙⲟⲛⲧ	qual
ⲥⲟⲃϩ	qual
ⲥⲟⲛϩ	sost_verb_pronqual
ⲥⲟⲟϥ	qual
ⲥⲟⲟⲩϩ	sost_verb_pronqual
ⲥⲟⲟⲩϩⲉϩⲟⲩⲛ	qual
ⲥⲟⲧⲡ	sost_verb_pronqual
ⲥⲟⲩⲗⲱⲗ	qual
ⲥⲟⲩⲧⲱⲛ	qual
ⲧϩⲧⲱϩ	qual
ⲧⲁϩⲉ	sost_verb_nomiqual
ⲧⲁϩⲏⲩ	qual
ⲧⲁϩⲙ	sost_verb_pronqual
ⲧⲁϩⲙⲉ	sost_verb_pronqual
ⲧⲁϫⲣⲏⲩ	qual
ⲧⲁⲉⲓⲏⲩ	qual
ⲧⲁⲓⲏⲩ	qual
ⲧⲁⲕⲏⲩ	qual
ⲧⲁⲗⲏⲩ	qual
ⲧⲃⲃⲏⲩ	qual
ⲧⲉϩⲧⲱϩ	qual
ⲧⲏϣ	qual
ⲧⲏⲕ	qual
ⲧⲏⲕⲛϩⲏⲧ	qual
ⲧⲙⲁⲉⲓⲏⲩ	qual
ⲧⲙⲁⲓⲏⲩ	qual
ⲧⲛⲧⲱⲛ	sost_verb_pronqual
ⲧⲟ	qual
ⲧⲟⲕ	qual
ⲧⲟⲕⲙ	qual
ⲧⲟⲙⲥ	sost_verb_pronqual
ⲧⲟⲟⲃⲉ	qual
ⲧⲟⲣϩ	qual
ⲧⲟⲩϫⲏⲩ	qual
ⲧⲥⲧⲏⲩ	qual
